"SAT.V","SAT.Q","SAT.C","School","GPA","Status"
690,580,1270,"BUSINESS",3.8235,"G"
530,710,1240,"NATURAL SCIENCE",3.5338,"G"
610,700,1310,"NATURAL SCIENCE",3.3679,"G"
730,700,1430,"ENGINEERING",3.3437,"G"
700,710,1410,"NATURAL SCIENCE",3.7205,"G"
540,690,1230,"LIBERAL ARTS",2.6851,"G"
740,680,1420,"ENGINEERING",3.614,"G"
590,660,1250,"BUSINESS",2.1403,"G"
540,540,1080,"LIBERAL ARTS",2.7441,"G"
550,580,1130,"LIBERAL ARTS",3.7741,"G"
800,650,1450,"LIBERAL ARTS",4,"G"
750,710,1460,"NATURAL SCIENCE",3.2408,"G"
630,710,1340,"LIBERAL ARTS",2.6521,"G"
710,700,1410,"LIBERAL ARTS",3.6277,"G"
670,660,1330,"LIBERAL ARTS",3.8646,"G"
630,710,1340,"COMMUNICATIONS",3.7669,"G"
660,680,1340,"ENGINEERING",3.4825,"G"
610,730,1340,"LIBERAL ARTS",3.85,"G"
530,630,1160,"ENGINEERING",2.7573,"G"
750,700,1450,"NATURAL SCIENCE",3.7179,"G"
650,580,1230,"FINE ARTS",3.9449,"G"
560,570,1130,"BUSINESS",3.6944,"G"
550,650,1200,"LIBERAL ARTS",3.3529,"G"
510,440,950,"LIBERAL ARTS",2.4033,"G"
580,640,1220,"LIBERAL ARTS",3.7032,"G"
540,680,1220,"LIBERAL ARTS",3.2758,"G"
590,590,1180,"LIBERAL ARTS",2.7341,"G"
720,670,1390,"LIBERAL ARTS",2.7258,"G"
680,660,1340,"NATURAL SCIENCE",3.0522,"G"
740,790,1530,"BUSINESS",3.6994,"G"
580,620,1200,"BUSINESS",3.2089,"G"
500,520,1020,"LIBERAL ARTS",2.8461,"G"
690,680,1370,"BUSINESS",3.2812,"G"
710,770,1480,"ENGINEERING",3.2534,"G"
540,560,1100,"NATURAL SCIENCE",3.2434,"G"
600,700,1300,"ENGINEERING",3.5891,"G"
700,750,1450,"ENGINEERING",4,"G"
560,660,1220,"LIBERAL ARTS",3.8644,"G"
550,700,1250,"FINE ARTS",2.8119,"G"
660,740,1400,"BUSINESS",3.7647,"G"
720,730,1450,"LIBERAL ARTS",3.7876,"G"
560,520,1080,"LIBERAL ARTS",3.1259,"G"
590,620,1210,"ENGINEERING",2.3801,"G"
580,630,1210,"BUSINESS",3.5945,"G"
560,560,1120,"LIBERAL ARTS",3.2692,"G"
670,640,1310,"COMMUNICATIONS",2.9687,"G"
690,710,1400,"NATURAL SCIENCE",3.6607,"G"
690,690,1380,"ENGINEERING",3.2919,"G"
690,600,1290,"ARCHITECTURE",3.5298,"G"
600,700,1300,"NATURAL SCIENCE",3.4444,"G"
540,610,1150,"NATURAL SCIENCE",3.7058,"G"
640,650,1290,"BUSINESS",3.0909,"G"
710,650,1360,"LIBERAL ARTS",3.75,"G"
680,580,1260,"LIBERAL ARTS",3.44,"G"
650,660,1310,"NATURAL SCIENCE",2.7681,"G"
690,530,1220,"SOCIAL WORK",3.7604,"G"
660,690,1350,"BUSINESS",3.7196,"G"
530,640,1170,"LIBERAL ARTS",3.407,"G"
650,580,1230,"BUSINESS",3.414,"G"
630,610,1240,"LIBERAL ARTS",3.03,"G"
640,650,1290,"BUSINESS",3.3076,"G"
650,800,1450,"LIBERAL ARTS",3.9343,"G"
690,640,1330,"EDUCATION",4,"G"
680,620,1300,"LIBERAL ARTS",2.9272,"G"
600,630,1230,"COMMUNICATIONS",3.6823,"G"
650,590,1240,"NATURAL SCIENCE",2.8194,"G"
610,540,1150,"FINE ARTS",3.8717,"G"
520,630,1150,"NATURAL SCIENCE",2.8985,"G"
650,780,1430,"ENGINEERING",2.8655,"G"
360,660,1020,"ENGINEERING",2.632,"G"
610,640,1250,"LIBERAL ARTS",2.7317,"G"
590,500,1090,"LIBERAL ARTS",3.754,"G"
600,660,1260,"BUSINESS",3.1632,"G"
640,660,1300,"LIBERAL ARTS",3.625,"G"
590,620,1210,"NATURAL SCIENCE",2.9469,"G"
520,610,1130,"BUSINESS",2.6617,"G"
690,650,1340,"LIBERAL ARTS",3.3703,"G"
380,710,1090,"LIBERAL ARTS",3.3089,"G"
470,490,960,"LIBERAL ARTS",3.3025,"G"
660,650,1310,"BUSINESS",3.0612,"G"
500,530,1030,"BUSINESS",2.6857,"G"
620,570,1190,"LIBERAL ARTS",2.7545,"G"
630,730,1360,"BUSINESS",3.2251,"G"
670,670,1340,"ARCHITECTURE",2.8593,"G"
620,570,1190,"LIBERAL ARTS",3.3096,"G"
530,560,1090,"LIBERAL ARTS",3.031,"G"
590,520,1110,"LIBERAL ARTS",3.4418,"G"
590,730,1320,"BUSINESS",3.4418,"G"
600,580,1180,"LIBERAL ARTS",2.6422,"G"
630,650,1280,"BUSINESS",3.1311,"G"
570,590,1160,"FINE ARTS",3.0697,"G"
630,670,1300,"ENGINEERING",3.0229,"G"
470,580,1050,"LIBERAL ARTS",2.6594,"G"
540,690,1230,"ENGINEERING",3.2935,"G"
670,550,1220,"COMMUNICATIONS",3.8659,"G"
600,460,1060,"COMMUNICATIONS",3.1296,"G"
570,630,1200,"LIBERAL ARTS",2.1503,"G"
690,610,1300,"LIBERAL ARTS",3.0306,"G"
680,700,1380,"ENGINEERING",2.8934,"G"
680,560,1240,"LIBERAL ARTS",3.7631,"G"
720,670,1390,"LIBERAL ARTS",4,"G"
700,750,1450,"BUSINESS",3.824,"G"
400,580,980,"ENGINEERING",3.5044,"G"
640,710,1350,"LIBERAL ARTS",3.6074,"G"
750,720,1470,"NATURAL SCIENCE",2.0954,"G"
530,510,1040,"LIBERAL ARTS",2.0674,"G"
580,630,1210,"LIBERAL ARTS",3.542,"G"
680,800,1480,"NATURAL SCIENCE",3.056,"G"
700,700,1400,"ENGINEERING",3.5766,"G"
550,710,1260,"NATURAL SCIENCE",2.5083,"G"
650,790,1440,"ENGINEERING",3.1166,"G"
780,670,1450,"NATURAL SCIENCE",3.5845,"G"
600,640,1240,"LIBERAL ARTS",3.26,"G"
580,670,1250,"NATURAL SCIENCE",3.1452,"G"
550,490,1040,"NATURAL SCIENCE",2.8796,"G"
480,600,1080,"LIBERAL ARTS",3.26,"G"
690,630,1320,"LIBERAL ARTS",3.1232,"G"
540,610,1150,"LIBERAL ARTS",3.3387,"G"
600,570,1170,"FINE ARTS",3.4765,"G"
560,560,1120,"BUSINESS",2.6688,"G"
480,670,1150,"ENGINEERING",2.8359,"G"
650,640,1290,"NATURAL SCIENCE",3.2826,"G"
750,680,1430,"BUSINESS",3.6017,"G"
700,750,1450,"ENGINEERING",2.0859,"G"
540,650,1190,"NATURAL SCIENCE",3.1727,"G"
630,660,1290,"NATURAL SCIENCE",3.5114,"G"
700,560,1260,"FINE ARTS",3.9052,"G"
630,590,1220,"BUSINESS",3.9672,"G"
600,550,1150,"LIBERAL ARTS",3.3958,"G"
670,760,1430,"BUSINESS",3.6538,"G"
700,720,1420,"ENGINEERING",3.8225,"G"
710,610,1320,"LIBERAL ARTS",3.7168,"G"
500,440,940,"LIBERAL ARTS",2.8984,"G"
680,800,1480,"ENGINEERING",3.968,"G"
590,560,1150,"LIBERAL ARTS",2.6688,"G"
580,530,1110,"COMMUNICATIONS",3.6526,"G"
650,760,1410,"LIBERAL ARTS",3.2982,"G"
560,720,1280,"NATURAL SCIENCE",2.5661,"G"
640,690,1330,"BUSINESS",2.9545,"G"
560,610,1170,"NATURAL SCIENCE",3.1791,"G"
560,640,1200,"NATURAL SCIENCE",3.832,"G"
600,580,1180,"BUSINESS",3.2524,"G"
540,440,980,"LIBERAL ARTS",2.9444,"G"
690,590,1280,"LIBERAL ARTS",2.8114,"G"
630,720,1350,"ENGINEERING",3.6535,"G"
470,530,1000,"LIBERAL ARTS",3.4158,"G"
510,650,1160,"NATURAL SCIENCE",2.9219,"G"
640,700,1340,"COMMUNICATIONS",2.9449,"G"
650,800,1450,"ENGINEERING",3.2705,"G"
630,720,1350,"LIBERAL ARTS",3.7413,"G"
600,660,1260,"BUSINESS",3.647,"G"
500,700,1200,"NATURAL SCIENCE",2.9065,"G"
540,620,1160,"NATURAL SCIENCE",3.7317,"G"
570,710,1280,"BUSINESS",3.8264,"G"
710,720,1430,"BUSINESS",3.4833,"G"
560,710,1270,"BUSINESS",3.75,"G"
710,720,1430,"LIBERAL ARTS",3.2865,"G"
610,650,1260,"COMMUNICATIONS",3.9361,"G"
670,530,1200,"COMMUNICATIONS",3.7131,"G"
460,510,970,"COMMUNICATIONS",3.0396,"G"
500,670,1170,"BUSINESS",3.1165,"G"
520,640,1160,"BUSINESS",3.3578,"G"
580,670,1250,"BUSINESS",2.4233,"G"
600,650,1250,"NATURAL SCIENCE",2.6691,"G"
610,740,1350,"BUSINESS",3.5983,"G"
650,740,1390,"ENGINEERING",3.0215,"G"
580,440,1020,"LIBERAL ARTS",3.5546,"G"
600,640,1240,"NATURAL SCIENCE",2.406,"G"
560,580,1140,"NATURAL SCIENCE",3.8461,"G"
650,710,1360,"LIBERAL ARTS",3.1192,"G"
790,800,1590,"BUSINESS",4,"G"
500,580,1080,"LIBERAL ARTS",3.1355,"G"
510,720,1230,"ENGINEERING",3.1395,"G"
490,530,1020,"LIBERAL ARTS",2.6046,"G"
660,660,1320,"NATURAL SCIENCE",3.8623,"G"
530,590,1120,"BUSINESS",3.115,"G"
660,750,1410,"LIBERAL ARTS",2.8434,"G"
630,540,1170,"EDUCATION",3.7478,"G"
580,470,1050,"NATURAL SCIENCE",3.2241,"G"
560,660,1220,"NATURAL SCIENCE",2.7647,"G"
680,650,1330,"FINE ARTS",3.8571,"G"
580,740,1320,"ENGINEERING",3.9295,"G"
720,690,1410,"ENGINEERING",3.3548,"G"
750,650,1400,"LIBERAL ARTS",3.5281,"G"
480,540,1020,"ENGINEERING",3.1,"G"
530,510,1040,"BUSINESS",3.3211,"G"
600,710,1310,"COMMUNICATIONS",3.6,"G"
600,740,1340,"NATURAL SCIENCE",3.129,"G"
650,740,1390,"BUSINESS",3.7767,"G"
450,450,900,"NATURAL SCIENCE",3.2647,"G"
570,530,1100,"LIBERAL ARTS",3.7391,"G"
680,610,1290,"NATURAL SCIENCE",3.6818,"G"
710,710,1420,"NATURAL SCIENCE",3.8085,"G"
780,790,1570,"BUSINESS",3.8211,"G"
790,760,1550,"BUSINESS",3.7583,"G"
540,650,1190,"BUSINESS",3.6915,"G"
690,740,1430,"LIBERAL ARTS",3.84,"G"
720,770,1490,"ENGINEERING",3.1842,"G"
580,530,1110,"LIBERAL ARTS",3.4424,"G"
560,600,1160,"LIBERAL ARTS",3.1086,"G"
680,700,1380,"BUSINESS",3.5784,"G"
640,640,1280,"ENGINEERING",3.2312,"G"
630,630,1260,"NATURAL SCIENCE",2.971,"G"
500,580,1080,"LIBERAL ARTS",3.0884,"G"
790,740,1530,"COMMUNICATIONS",3.7972,"G"
660,610,1270,"COMMUNICATIONS",3.8584,"G"
540,470,1010,"NATURAL SCIENCE",3.4711,"G"
720,520,1240,"LIBERAL ARTS",2.7538,"G"
640,620,1260,"LIBERAL ARTS",3.5851,"G"
570,520,1090,"LIBERAL ARTS",2.8191,"G"
620,730,1350,"BUSINESS",2.7478,"G"
710,690,1400,"LIBERAL ARTS",2.8691,"G"
570,660,1230,"BUSINESS",4,"G"
630,590,1220,"LIBERAL ARTS",3.0268,"G"
630,590,1220,"LIBERAL ARTS",3.3442,"G"
380,540,920,"LIBERAL ARTS",2.6132,"G"
570,600,1170,"LIBERAL ARTS",3.1098,"G"
480,580,1060,"LIBERAL ARTS",2.8139,"G"
570,640,1210,"FINE ARTS",3.8,"G"
520,630,1150,"NATURAL SCIENCE",2.6551,"G"
730,710,1440,"LIBERAL ARTS",3.1735,"G"
700,620,1320,"LIBERAL ARTS",3.2714,"G"
690,490,1180,"EDUCATION",2.5681,"G"
510,580,1090,"BUSINESS",2.3781,"G"
600,670,1270,"LIBERAL ARTS",3.8446,"G"
620,620,1240,"BUSINESS",3.5064,"G"
680,740,1420,"NATURAL SCIENCE",3.892,"G"
670,700,1370,"LIBERAL ARTS",3.4489,"G"
650,650,1300,"LIBERAL ARTS",3.9186,"G"
700,660,1360,"ENGINEERING",3.8362,"G"
750,790,1540,"NATURAL SCIENCE",3.7967,"G"
630,540,1170,"LIBERAL ARTS",2.466,"G"
770,640,1410,"LIBERAL ARTS",3.2975,"G"
540,610,1150,"NATURAL SCIENCE",3.2959,"G"
690,670,1360,"LIBERAL ARTS",2.5267,"G"
690,800,1490,"ENGINEERING",3.8913,"G"
770,630,1400,"COMMUNICATIONS",3.2051,"G"
530,570,1100,"LIBERAL ARTS",3.1595,"G"
650,580,1230,"ENGINEERING",3.0245,"G"
540,620,1160,"FINE ARTS",3.3606,"G"
650,660,1310,"BUSINESS",3.9439,"G"
760,690,1450,"LIBERAL ARTS",3.7445,"G"
570,590,1160,"BUSINESS",3.4134,"G"
720,670,1390,"BUSINESS",3.8723,"G"
630,640,1270,"LIBERAL ARTS",3.2666,"G"
510,540,1050,"BUSINESS",2.8425,"G"
550,530,1080,"LIBERAL ARTS",3.2989,"G"
650,690,1340,"LIBERAL ARTS",3.68,"G"
590,570,1160,"FINE ARTS",3.2777,"G"
690,660,1350,"LIBERAL ARTS",3.8672,"G"
640,650,1290,"NATURAL SCIENCE",3.6384,"G"
600,620,1220,"LIBERAL ARTS",2.7551,"G"
540,540,1080,"LIBERAL ARTS",3,"G"
570,650,1220,"NATURAL SCIENCE",2.6541,"G"
570,640,1210,"NATURAL SCIENCE",4,"G"
690,680,1370,"NATURAL SCIENCE",3.8461,"G"
730,650,1380,"LIBERAL ARTS",3.9512,"G"
600,640,1240,"LIBERAL ARTS",2.8911,"G"
710,650,1360,"ENGINEERING",3.7934,"G"
540,740,1280,"ENGINEERING",3.4594,"G"
480,590,1070,"NATURAL SCIENCE",2.4786,"G"
690,710,1400,"LIBERAL ARTS",3.8487,"G"
560,660,1220,"EDUCATION",3.8181,"G"
590,580,1170,"LIBERAL ARTS",2.835,"G"
670,790,1460,"ENGINEERING",3.6861,"G"
620,570,1190,"NATURAL SCIENCE",3.4,"G"
610,490,1100,"LIBERAL ARTS",2.5,"G"
650,770,1420,"NATURAL SCIENCE",4,"G"
530,580,1110,"LIBERAL ARTS",3.1666,"G"
700,610,1310,"LIBERAL ARTS",3.198,"G"
510,520,1030,"LIBERAL ARTS",3.3854,"G"
560,680,1240,"EDUCATION",3.2164,"G"
590,540,1130,"LIBERAL ARTS",2.6803,"G"
630,710,1340,"NATURAL SCIENCE",3.4821,"G"
690,600,1290,"LIBERAL ARTS",3.62,"G"
650,650,1300,"LIBERAL ARTS",2.6637,"G"
800,750,1550,"ENGINEERING",3.777,"G"
590,590,1180,"NATURAL SCIENCE",3.4586,"G"
670,710,1380,"ENGINEERING",3.3088,"G"
590,590,1180,"NATURAL SCIENCE",3.254,"G"
660,640,1300,"BUSINESS",3.9459,"G"
580,620,1200,"ENGINEERING",2.603,"G"
590,570,1160,"LIBERAL ARTS",3.3508,"G"
520,660,1180,"LIBERAL ARTS",3.1212,"G"
620,710,1330,"ARCHITECTURE",3.902,"G"
660,620,1280,"LIBERAL ARTS",3.5188,"G"
580,760,1340,"LIBERAL ARTS",3.375,"G"
450,620,1070,"BUSINESS",3.0093,"G"
560,580,1140,"NATURAL SCIENCE",2.931,"G"
720,670,1390,"NATURAL SCIENCE",3.8018,"G"
670,790,1460,"NATURAL SCIENCE",3.9808,"G"
630,710,1340,"ENGINEERING",3.0151,"G"
700,590,1290,"LIBERAL ARTS",3.9565,"G"
610,730,1340,"ENGINEERING",3.6694,"G"
560,660,1220,"COMMUNICATIONS",4,"G"
640,680,1320,"NATURAL SCIENCE",2.3157,"G"
540,550,1090,"NATURAL SCIENCE",3.1848,"G"
700,690,1390,"ENGINEERING",3.921,"G"
570,610,1180,"NATURAL SCIENCE",3.3642,"G"
670,630,1300,"LIBERAL ARTS",4,"G"
530,590,1120,"LIBERAL ARTS",2.673,"G"
630,600,1230,"LIBERAL ARTS",3.0833,"G"
690,800,1490,"NATURAL SCIENCE",3.5942,"G"
440,430,870,"LIBERAL ARTS",3.7812,"G"
580,610,1190,"BUSINESS",3.26,"G"
560,610,1170,"ENGINEERING",2.4068,"G"
740,720,1460,"ARCHITECTURE",4,"G"
510,560,1070,"NATURAL SCIENCE",3.9224,"G"
700,640,1340,"LIBERAL ARTS",3.8032,"G"
540,640,1180,"NATURAL SCIENCE",2.9448,"G"
710,760,1470,"ENGINEERING",2.7777,"G"
580,650,1230,"NATURAL SCIENCE",3.6615,"G"
560,630,1190,"LIBERAL ARTS",3.1403,"G"
740,700,1440,"NATURAL SCIENCE",3.0645,"G"
550,590,1140,"LIBERAL ARTS",2.9,"G"
660,650,1310,"LIBERAL ARTS",3.2083,"G"
600,560,1160,"NATURAL SCIENCE",3.1926,"G"
680,610,1290,"LIBERAL ARTS",3.3723,"G"
670,680,1350,"LIBERAL ARTS",3.4166,"G"
470,580,1050,"ENGINEERING",3.248,"G"
640,740,1380,"COMMUNICATIONS",3.7142,"G"
800,630,1430,"LIBERAL ARTS",3.5048,"G"
760,620,1380,"LIBERAL ARTS",3.8396,"G"
380,520,900,"ENGINEERING",3.1594,"G"
630,670,1300,"NATURAL SCIENCE",2.745,"G"
710,690,1400,"LIBERAL ARTS",3.8598,"G"
680,630,1310,"LIBERAL ARTS",3.9381,"G"
630,620,1250,"COMMUNICATIONS",3.7474,"G"
520,580,1100,"LIBERAL ARTS",2.2421,"G"
610,520,1130,"LIBERAL ARTS",3.1652,"G"
570,580,1150,"BUSINESS",3.5227,"G"
670,670,1340,"ENGINEERING",3.9347,"G"
630,560,1190,"NATURAL SCIENCE",3.6504,"G"
710,780,1490,"ENGINEERING",3.6763,"G"
630,580,1210,"FINE ARTS",3.3113,"G"
710,710,1420,"LIBERAL ARTS",3.9181,"G"
440,450,890,"LIBERAL ARTS",3.5982,"G"
590,670,1260,"BUSINESS",3.3719,"G"
610,640,1250,"LIBERAL ARTS",2.783,"G"
540,690,1230,"LIBERAL ARTS",3.1056,"G"
760,770,1530,"NATURAL SCIENCE",3.5901,"G"
630,790,1420,"ARCHITECTURE",3.9219,"G"
480,710,1190,"BUSINESS",3.5148,"G"
710,640,1350,"LIBERAL ARTS",2.6982,"G"
510,490,1000,"LIBERAL ARTS",3,"G"
730,710,1440,"BUSINESS",3.6465,"G"
630,610,1240,"FINE ARTS",3.6019,"G"
510,630,1140,"LIBERAL ARTS",3.1065,"G"
530,620,1150,"LIBERAL ARTS",3.7714,"G"
710,630,1340,"COMMUNICATIONS",3.9719,"G"
630,600,1230,"NATURAL SCIENCE",3.7009,"G"
520,460,980,"LIBERAL ARTS",3.3125,"G"
540,760,1300,"ENGINEERING",3.1404,"G"
740,770,1510,"ENGINEERING",3.5757,"G"
630,690,1320,"BUSINESS",3.8739,"G"
750,680,1430,"LIBERAL ARTS",3.5966,"G"
700,630,1330,"COMMUNICATIONS",3.2805,"G"
540,640,1180,"LIBERAL ARTS",2.8017,"G"
650,580,1230,"LIBERAL ARTS",3.5,"G"
550,650,1200,"EDUCATION",2.6428,"G"
650,670,1320,"LIBERAL ARTS",3.8974,"G"
520,590,1110,"BUSINESS",3.4392,"G"
430,500,930,"LIBERAL ARTS",2.4435,"G"
650,700,1350,"NATURAL SCIENCE",4,"G"
580,570,1150,"LIBERAL ARTS",2.8318,"G"
700,720,1420,"NATURAL SCIENCE",3.5968,"G"
530,410,940,"COMMUNICATIONS",2.8548,"G"
580,650,1230,"LIBERAL ARTS",3.5039,"G"
630,650,1280,"ARCHITECTURE",3.2888,"G"
600,550,1150,"BUSINESS",3.8857,"G"
590,560,1150,"LIBERAL ARTS",3.3125,"G"
640,710,1350,"ENGINEERING",2.5,"G"
710,580,1290,"NATURAL SCIENCE",2.9509,"G"
540,580,1120,"NATURAL SCIENCE",2.4205,"G"
710,720,1430,"BUSINESS",3.629,"G"
600,630,1230,"LIBERAL ARTS",3.8015,"G"
600,560,1160,"LIBERAL ARTS",2.2935,"G"
630,710,1340,"NATURAL SCIENCE",3.5648,"G"
520,580,1100,"LIBERAL ARTS",3.6888,"G"
710,580,1290,"NATURAL SCIENCE",2.912,"G"
600,540,1140,"NATURAL SCIENCE",3.6896,"G"
510,520,1030,"NATURAL SCIENCE",2.909,"G"
530,600,1130,"BUSINESS",3.2148,"G"
530,660,1190,"LIBERAL ARTS",2.8983,"G"
640,560,1200,"BUSINESS",3.302,"G"
620,650,1270,"ENGINEERING",3.48,"G"
650,620,1270,"NATURAL SCIENCE",2.8372,"G"
510,490,1000,"EDUCATION",3.0458,"G"
520,540,1060,"COMMUNICATIONS",3.6237,"G"
490,490,980,"LIBERAL ARTS",2.8727,"G"
650,660,1310,"NATURAL SCIENCE",3.3688,"G"
800,710,1510,"ENGINEERING",3.8496,"G"
630,710,1340,"LIBERAL ARTS",2.4818,"G"
450,510,960,"BUSINESS",3.3928,"G"
660,510,1170,"LIBERAL ARTS",2.822,"G"
540,630,1170,"LIBERAL ARTS",3.144,"G"
710,560,1270,"BUSINESS",3.488,"G"
730,640,1370,"FINE ARTS",3.7226,"G"
610,670,1280,"ENGINEERING",2.7833,"G"
480,570,1050,"ENGINEERING",2.6451,"G"
700,530,1230,"LIBERAL ARTS",3.1588,"G"
750,700,1450,"BUSINESS",3.6415,"G"
390,620,1010,"FINE ARTS",2.9142,"G"
620,700,1320,"NATURAL SCIENCE",3.7864,"G"
590,490,1080,"NATURAL SCIENCE",3.7272,"G"
600,570,1170,"LIBERAL ARTS",2.6237,"G"
640,750,1390,"NATURAL SCIENCE",2.9556,"G"
620,560,1180,"BUSINESS",3.404,"G"
760,670,1430,"COMMUNICATIONS",2.9774,"G"
720,610,1330,"LIBERAL ARTS",2.8201,"G"
680,670,1350,"ENGINEERING",3.406,"G"
670,720,1390,"NATURAL SCIENCE",3.4464,"G"
580,710,1290,"NATURAL SCIENCE",3.1517,"G"
690,630,1320,"LIBERAL ARTS",2.8793,"G"
650,600,1250,"NATURAL SCIENCE",3.1682,"G"
630,570,1200,"NATURAL SCIENCE",2.632,"G"
670,790,1460,"ENGINEERING",3.9736,"G"
590,530,1120,"EDUCATION",3.0984,"G"
690,800,1490,"ENGINEERING",3.6065,"G"
570,650,1220,"COMMUNICATIONS",3.4757,"G"
570,610,1180,"LIBERAL ARTS",3.51,"G"
700,630,1330,"NATURAL SCIENCE",2.676,"G"
640,720,1360,"NATURAL SCIENCE",3.5952,"G"
700,700,1400,"LIBERAL ARTS",3.7459,"G"
600,560,1160,"BUSINESS",3.1965,"G"
520,530,1050,"NATURAL SCIENCE",2.7741,"G"
490,420,910,"LIBERAL ARTS",3.809,"G"
540,610,1150,"ENGINEERING",2.8309,"G"
480,620,1100,"BUSINESS",3.2187,"G"
550,590,1140,"LIBERAL ARTS",3.0808,"G"
660,700,1360,"LIBERAL ARTS",3.8839,"G"
630,700,1330,"BUSINESS",3.5703,"G"
750,680,1430,"LIBERAL ARTS",4,"G"
630,650,1280,"BUSINESS",3.6057,"G"
620,650,1270,"NATURAL SCIENCE",1.8372,"G"
490,440,930,"BUSINESS",3.2413,"G"
540,720,1260,"NATURAL SCIENCE",3.3664,"G"
610,610,1220,"NATURAL SCIENCE",2.5271,"G"
700,660,1360,"NATURAL SCIENCE",3.876,"G"
460,530,990,"LIBERAL ARTS",2.5691,"G"
720,790,1510,"ENGINEERING",3.3492,"G"
580,600,1180,"NATURAL SCIENCE",3.3015,"G"
500,570,1070,"NURSING",3.3649,"G"
560,800,1360,"ENGINEERING",2.7633,"G"
600,720,1320,"BUSINESS",3.2847,"G"
720,770,1490,"NATURAL SCIENCE",3.612,"G"
580,610,1190,"LIBERAL ARTS",3.1796,"G"
700,740,1440,"ENGINEERING",3.6928,"G"
540,630,1170,"LIBERAL ARTS",3.0088,"G"
520,470,990,"LIBERAL ARTS",2.7592,"G"
610,560,1170,"COMMUNICATIONS",3.7446,"G"
700,550,1250,"NATURAL SCIENCE",3.2012,"G"
590,630,1220,"LIBERAL ARTS",2.1646,"G"
700,610,1310,"NATURAL SCIENCE",2.8761,"G"
530,450,980,"LIBERAL ARTS",3.4871,"G"
490,560,1050,"LIBERAL ARTS",3.0923,"G"
800,660,1460,"NATURAL SCIENCE",2.6642,"G"
460,550,1010,"LIBERAL ARTS",2.6783,"G"
610,610,1220,"ENGINEERING",2.6619,"G"
580,670,1250,"NATURAL SCIENCE",2.785,"G"
630,640,1270,"LIBERAL ARTS",3.0648,"G"
530,640,1170,"NATURAL SCIENCE",2.5189,"G"
610,690,1300,"BUSINESS",3.9491,"G"
640,690,1330,"ENGINEERING",3.653,"G"
550,550,1100,"BUSINESS",3.3178,"G"
490,550,1040,"LIBERAL ARTS",2.6808,"G"
540,650,1190,"LIBERAL ARTS",2.6262,"G"
640,730,1370,"ARCHITECTURE",3.7304,"G"
600,680,1280,"NATURAL SCIENCE",2.6323,"G"
710,570,1280,"LIBERAL ARTS",3.5128,"G"
580,590,1170,"BUSINESS",3.2248,"G"
640,760,1400,"ENGINEERING",3.6393,"G"
580,710,1290,"LIBERAL ARTS",2.4491,"G"
550,650,1200,"LIBERAL ARTS",3.3177,"G"
530,520,1050,"EDUCATION",2.5609,"G"
680,610,1290,"COMMUNICATIONS",3.5677,"G"
590,550,1140,"NATURAL SCIENCE",2.648,"G"
570,650,1220,"NATURAL SCIENCE",2.4652,"G"
600,700,1300,"NATURAL SCIENCE",2.3839,"G"
550,710,1260,"BUSINESS",3.102,"G"
600,690,1290,"ENGINEERING",3.296,"G"
480,510,990,"LIBERAL ARTS",2.4237,"G"
540,550,1090,"LIBERAL ARTS",3.2719,"G"
760,710,1470,"NATURAL SCIENCE",2.8029,"G"
650,620,1270,"NATURAL SCIENCE",2.9256,"G"
640,560,1200,"LIBERAL ARTS",2.6818,"G"
650,720,1370,"ENGINEERING",3.8235,"G"
630,610,1240,"ENGINEERING",3.4234,"G"
740,740,1480,"BUSINESS",3.619,"G"
580,720,1300,"NATURAL SCIENCE",2.3984,"G"
700,750,1450,"ENGINEERING",2.6228,"G"
590,710,1300,"COMMUNICATIONS",3.125,"G"
540,650,1190,"ENGINEERING",3.4107,"G"
620,680,1300,"COMMUNICATIONS",2.5984,"G"
650,760,1410,"NATURAL SCIENCE",2.9589,"G"
630,630,1260,"LIBERAL ARTS",2.9826,"G"
550,560,1110,"LIBERAL ARTS",3.2844,"G"
670,580,1250,"LIBERAL ARTS",3.6076,"G"
380,510,890,"LIBERAL ARTS",2.0982,"G"
440,510,950,"ENGINEERING",3.0326,"G"
400,590,990,"EDUCATION",3.5339,"G"
620,540,1160,"LIBERAL ARTS",3.5294,"G"
590,600,1190,"BUSINESS",3.0673,"G"
630,620,1250,"BUSINESS",2.3025,"G"
520,530,1050,"BUSINESS",2.488,"G"
590,680,1270,"NATURAL SCIENCE",3,"G"
590,700,1290,"ENGINEERING",2.7898,"G"
730,640,1370,"LIBERAL ARTS",3.7573,"G"
630,620,1250,"NATURAL SCIENCE",3.8828,"G"
740,660,1400,"ENGINEERING",3.5701,"G"
670,730,1400,"BUSINESS",3.8151,"G"
620,640,1260,"ENGINEERING",2.4919,"G"
660,600,1260,"LIBERAL ARTS",3.425,"G"
530,630,1160,"LIBERAL ARTS",3.4038,"G"
690,640,1330,"BUSINESS",3.3643,"G"
570,490,1060,"LIBERAL ARTS",3.6272,"G"
750,730,1480,"ENGINEERING",3.4507,"G"
500,670,1170,"NATURAL SCIENCE",2.6296,"G"
650,710,1360,"BUSINESS",3.7281,"G"
610,790,1400,"ENGINEERING",3.8492,"G"
610,570,1180,"LIBERAL ARTS",3.4568,"G"
610,640,1250,"BUSINESS",3.3965,"G"
450,540,990,"LIBERAL ARTS",3.4,"G"
630,670,1300,"LIBERAL ARTS",3.4598,"G"
580,740,1320,"ENGINEERING",3.0884,"G"
720,750,1470,"NATURAL SCIENCE",3.9025,"G"
570,770,1340,"NATURAL SCIENCE",2.8012,"G"
650,550,1200,"LIBERAL ARTS",3.3934,"G"
560,590,1150,"LIBERAL ARTS",3,"G"
600,630,1230,"NATURAL SCIENCE",3.2421,"G"
650,610,1260,"LIBERAL ARTS",3.8672,"G"
490,690,1180,"NATURAL SCIENCE",2.6935,"G"
570,580,1150,"LIBERAL ARTS",2.9318,"G"
510,720,1230,"ENGINEERING",2.5967,"G"
630,790,1420,"ENGINEERING",4,"G"
540,620,1160,"LIBERAL ARTS",3.496,"G"
800,700,1500,"LIBERAL ARTS",3.8507,"G"
700,570,1270,"BUSINESS",3.8659,"G"
790,660,1450,"NATURAL SCIENCE",3.2751,"G"
600,560,1160,"ENGINEERING",2.4814,"G"
620,640,1260,"NATURAL SCIENCE",3.3937,"G"
580,680,1260,"ENGINEERING",2.7622,"G"
580,660,1240,"BUSINESS",3.9055,"G"
670,580,1250,"FINE ARTS",3.3597,"G"
520,630,1150,"NATURAL SCIENCE",3.3333,"G"
580,640,1220,"NATURAL SCIENCE",3.352,"G"
800,800,1600,"NATURAL SCIENCE",3.9774,"G"
640,790,1430,"ENGINEERING",2.5118,"G"
500,590,1090,"LIBERAL ARTS",3.375,"G"
700,710,1410,"ENGINEERING",3.5163,"G"
590,650,1240,"NATURAL SCIENCE",2.7542,"G"
680,560,1240,"NATURAL SCIENCE",3.9142,"G"
620,570,1190,"LIBERAL ARTS",3.7985,"G"
630,760,1390,"ENGINEERING",3.3983,"G"
620,640,1260,"NATURAL SCIENCE",2.3722,"G"
720,740,1460,"COMMUNICATIONS",3.8974,"G"
560,650,1210,"NATURAL SCIENCE",3.7345,"G"
650,690,1340,"LIBERAL ARTS",3.1272,"G"
760,770,1530,"ENGINEERING",3.9785,"G"
620,710,1330,"LIBERAL ARTS",3.944,"G"
690,650,1340,"LIBERAL ARTS",3.2598,"G"
640,690,1330,"LIBERAL ARTS",3.6504,"G"
640,680,1320,"LIBERAL ARTS",2.5816,"G"
660,690,1350,"NATURAL SCIENCE",3.4754,"G"
580,570,1150,"LIBERAL ARTS",3.0275,"G"
660,660,1320,"ENGINEERING",3.4776,"G"
610,710,1320,"LIBERAL ARTS",3.2521,"G"
630,590,1220,"LIBERAL ARTS",2.7586,"G"
510,590,1100,"BUSINESS",3.3191,"G"
470,450,920,"COMMUNICATIONS",2.94,"G"
620,630,1250,"BUSINESS",3.4526,"G"
570,650,1220,"ENGINEERING",3.5041,"G"
680,740,1420,"NATURAL SCIENCE",3.3356,"G"
610,590,1200,"LIBERAL ARTS",3.6847,"G"
500,520,1020,"LIBERAL ARTS",3.2442,"G"
480,510,990,"LIBERAL ARTS",3.0423,"G"
730,610,1340,"LIBERAL ARTS",3.784,"G"
640,650,1290,"BUSINESS",3.2321,"G"
630,770,1400,"COMMUNICATIONS",3.3207,"G"
760,700,1460,"LIBERAL ARTS",3.7706,"G"
650,590,1240,"LIBERAL ARTS",2.7029,"G"
640,660,1300,"NATURAL SCIENCE",3.3445,"G"
570,610,1180,"LIBERAL ARTS",3.3311,"G"
560,530,1090,"FINE ARTS",3.2198,"G"
440,380,820,"LIBERAL ARTS",3.042,"G"
600,720,1320,"NATURAL SCIENCE",3.384,"G"
670,680,1350,"ENGINEERING",3.4672,"G"
590,630,1220,"NATURAL SCIENCE",2.4171,"G"
800,690,1490,"ENGINEERING",2.8833,"G"
500,640,1140,"ENGINEERING",3,"G"
710,540,1250,"LIBERAL ARTS",2.5537,"G"
580,590,1170,"LIBERAL ARTS",3.0582,"G"
720,790,1510,"LIBERAL ARTS",3.7916,"G"
590,560,1150,"BUSINESS",3.901,"G"
750,640,1390,"NATURAL SCIENCE",3.2935,"G"
570,490,1060,"COMMUNICATIONS",3.7096,"G"
630,570,1200,"COMMUNICATIONS",3.7333,"G"
530,630,1160,"ENGINEERING",3.2049,"G"
720,620,1340,"NATURAL SCIENCE",3.6851,"G"
550,720,1270,"ENGINEERING",3.61,"G"
570,690,1260,"BUSINESS",3.0219,"G"
600,650,1250,"ARCHITECTURE",3.2483,"G"
570,490,1060,"EDUCATION",3.2673,"G"
550,590,1140,"ENGINEERING",2.8796,"G"
550,660,1210,"NATURAL SCIENCE",3.47,"G"
650,700,1350,"BUSINESS",3.71,"G"
520,450,970,"NATURAL SCIENCE",3.2038,"G"
580,580,1160,"LIBERAL ARTS",3.7936,"G"
570,590,1160,"ENGINEERING",3.4297,"G"
540,530,1070,"NATURAL SCIENCE",2.7187,"G"
690,660,1350,"LIBERAL ARTS",4,"G"
560,620,1180,"BUSINESS",3.0927,"G"
600,670,1270,"ENGINEERING",2.2571,"G"
520,580,1100,"LIBERAL ARTS",2.38,"G"
590,680,1270,"NATURAL SCIENCE",3.6554,"G"
490,520,1010,"NATURAL SCIENCE",2.2142,"G"
710,670,1380,"COMMUNICATIONS",3.7211,"G"
660,660,1320,"NATURAL SCIENCE",3.8173,"G"
560,700,1260,"LIBERAL ARTS",3.4596,"G"
510,610,1120,"BUSINESS",3,"G"
450,580,1030,"ENGINEERING",3.6695,"G"
630,620,1250,"LIBERAL ARTS",3.6792,"G"
360,430,790,"FINE ARTS",2.8173,"G"
690,590,1280,"LIBERAL ARTS",3.4811,"G"
580,560,1140,"LIBERAL ARTS",3.374,"G"
630,530,1160,"EDUCATION",3.06,"G"
480,470,950,"COMMUNICATIONS",2.7735,"G"
710,570,1280,"LIBERAL ARTS",3.7326,"G"
770,650,1420,"BUSINESS",3.9758,"G"
630,760,1390,"LIBERAL ARTS",3.9029,"G"
620,550,1170,"NATURAL SCIENCE",2.2735,"G"
620,710,1330,"NATURAL SCIENCE",3.5,"G"
650,680,1330,"BUSINESS",2.9885,"G"
530,690,1220,"ENGINEERING",2.9285,"G"
700,700,1400,"LIBERAL ARTS",3.9281,"G"
440,520,960,"LIBERAL ARTS",2.9464,"G"
590,650,1240,"LIBERAL ARTS",2.6268,"G"
690,620,1310,"COMMUNICATIONS",3.6071,"G"
720,710,1430,"NATURAL SCIENCE",3.2301,"G"
590,540,1130,"LIBERAL ARTS",3.3039,"G"
590,770,1360,"ENGINEERING",3.5398,"G"
500,580,1080,"NATURAL SCIENCE",3.082,"G"
730,680,1410,"NATURAL SCIENCE",4,"G"
600,620,1220,"EDUCATION",3.3207,"G"
500,590,1090,"BUSINESS",3.2931,"G"
690,630,1320,"COMMUNICATIONS",3.6902,"G"
600,610,1210,"NATURAL SCIENCE",2.9741,"G"
620,600,1220,"NATURAL SCIENCE",3.5268,"G"
500,590,1090,"ENGINEERING",2.9349,"G"
610,530,1140,"LIBERAL ARTS",3.1401,"G"
590,660,1250,"BUSINESS",3.1639,"G"
700,720,1420,"LIBERAL ARTS",2.8349,"G"
610,500,1110,"COMMUNICATIONS",3.5048,"G"
600,560,1160,"LIBERAL ARTS",3.4553,"G"
520,750,1270,"ENGINEERING",3.5238,"G"
590,600,1190,"BUSINESS",2.9652,"G"
560,570,1130,"NATURAL SCIENCE",3.5426,"G"
560,640,1200,"BUSINESS",3.1909,"G"
520,650,1170,"NATURAL SCIENCE",3.2352,"G"
470,370,840,"BUSINESS",2.7904,"G"
690,650,1340,"ENGINEERING",3.3428,"G"
490,640,1130,"BUSINESS",3.1511,"G"
610,580,1190,"FINE ARTS",3.712,"G"
540,560,1100,"LIBERAL ARTS",2.229,"G"
560,580,1140,"FINE ARTS",3.021,"G"
590,630,1220,"LIBERAL ARTS",2.8943,"G"
520,520,1040,"BUSINESS",2.7089,"G"
540,610,1150,"EDUCATION",3.8144,"G"
570,760,1330,"ENGINEERING",2.255,"G"
640,710,1350,"NATURAL SCIENCE",2.8879,"G"
580,630,1210,"COMMUNICATIONS",3.5949,"G"
610,550,1160,"EDUCATION",3.8362,"G"
540,790,1330,"ENGINEERING",3.31,"G"
680,670,1350,"BUSINESS",3.5714,"G"
600,560,1160,"BUSINESS",3.4166,"G"
640,540,1180,"NATURAL SCIENCE",2.79,"G"
700,720,1420,"BUSINESS",3.2372,"G"
520,450,970,"LIBERAL ARTS",3.2924,"G"
610,610,1220,"NATURAL SCIENCE",3.1818,"G"
540,590,1130,"BUSINESS",3.536,"G"
540,590,1130,"BUSINESS",3.2978,"G"
430,500,930,"LIBERAL ARTS",3.6785,"G"
600,660,1260,"NATURAL SCIENCE",2.4187,"G"
530,620,1150,"LIBERAL ARTS",2.4959,"G"
650,690,1340,"BUSINESS",3.3025,"G"
590,660,1250,"BUSINESS",3.4565,"G"
650,650,1300,"BUSINESS",3.7822,"G"
550,530,1080,"NATURAL SCIENCE",2.4468,"G"
720,700,1420,"BUSINESS",3.2672,"G"
560,650,1210,"NATURAL SCIENCE",3.0901,"G"
530,580,1110,"ENGINEERING",2.4718,"G"
460,570,1030,"LIBERAL ARTS",2.7547,"G"
580,570,1150,"LIBERAL ARTS",3.9032,"G"
500,550,1050,"NATURAL SCIENCE",3.1726,"G"
650,620,1270,"LIBERAL ARTS",2.923,"G"
640,700,1340,"BUSINESS",3.8141,"G"
570,490,1060,"LIBERAL ARTS",3.1585,"G"
400,560,960,"BUSINESS",3.0508,"G"
620,610,1230,"BUSINESS",2.3937,"G"
660,720,1380,"NATURAL SCIENCE",3.8055,"G"
470,560,1030,"LIBERAL ARTS",3.6373,"G"
530,580,1110,"ENGINEERING",2.6791,"G"
580,650,1230,"LIBERAL ARTS",3.3586,"G"
580,670,1250,"ENGINEERING",3.5866,"G"
480,510,990,"BUSINESS",2.3823,"G"
760,730,1490,"LIBERAL ARTS",3.9347,"G"
580,590,1170,"NURSING",3.2954,"G"
760,800,1560,"LIBERAL ARTS",3.2921,"G"
480,570,1050,"LIBERAL ARTS",2.7096,"G"
600,720,1320,"ENGINEERING",3.375,"G"
460,600,1060,"ENGINEERING",3.0564,"G"
570,620,1190,"LIBERAL ARTS",2.5454,"G"
610,610,1220,"LIBERAL ARTS",3.67,"G"
670,590,1260,"LIBERAL ARTS",3.5691,"G"
540,610,1150,"LIBERAL ARTS",3.3363,"G"
580,570,1150,"NATURAL SCIENCE",2.7714,"G"
630,720,1350,"BUSINESS",3.7777,"G"
650,560,1210,"LIBERAL ARTS",2.0072,"G"
650,590,1240,"LIBERAL ARTS",3.349,"G"
710,600,1310,"LIBERAL ARTS",3.1946,"G"
520,600,1120,"LIBERAL ARTS",2.343,"G"
580,590,1170,"NATURAL SCIENCE",2.244,"G"
630,560,1190,"FINE ARTS",3.1847,"G"
540,710,1250,"NATURAL SCIENCE",3.5692,"G"
520,580,1100,"EDUCATION",3.8543,"G"
640,730,1370,"NATURAL SCIENCE",3.75,"G"
570,540,1110,"BUSINESS",3.38,"G"
540,490,1030,"FINE ARTS",2.7412,"G"
550,720,1270,"NATURAL SCIENCE",3.252,"G"
660,740,1400,"FINE ARTS",3.3388,"G"
510,660,1170,"LIBERAL ARTS",2.375,"G"
650,610,1260,"LIBERAL ARTS",3.525,"G"
530,620,1150,"LIBERAL ARTS",2.875,"G"
530,680,1210,"BUSINESS",2.0659,"G"
640,550,1190,"LIBERAL ARTS",2.4521,"G"
440,490,930,"BUSINESS",2.407,"G"
610,550,1160,"BUSINESS",3.4174,"G"
630,720,1350,"ENGINEERING",3.0194,"G"
510,630,1140,"NATURAL SCIENCE",3.8256,"G"
570,690,1260,"LIBERAL ARTS",2.8267,"G"
660,720,1380,"ENGINEERING",3.921,"G"
610,790,1400,"ENGINEERING",3.8356,"G"
590,610,1200,"BUSINESS",3.0073,"G"
580,630,1210,"COMMUNICATIONS",3.0526,"G"
630,640,1270,"FINE ARTS",2.9854,"G"
450,430,880,"LIBERAL ARTS",2.344,"G"
630,550,1180,"BUSINESS",3.5428,"G"
550,610,1160,"LIBERAL ARTS",2.6525,"G"
630,670,1300,"NATURAL SCIENCE",3.6129,"G"
500,560,1060,"EDUCATION",2.6612,"G"
570,560,1130,"NATURAL SCIENCE",3.5631,"G"
470,570,1040,"LIBERAL ARTS",2.4507,"G"
680,610,1290,"NATURAL SCIENCE",3.7196,"G"
690,750,1440,"ENGINEERING",3.7522,"G"
690,720,1410,"BUSINESS",3.6597,"G"
640,710,1350,"ARCHITECTURE",3.8434,"G"
580,580,1160,"ENGINEERING",2.9032,"G"
650,620,1270,"NATURAL SCIENCE",3.2824,"G"
710,790,1500,"NATURAL SCIENCE",3.0827,"G"
540,730,1270,"ENGINEERING",2.4666,"G"
480,570,1050,"ENGINEERING",3.6488,"G"
550,570,1120,"LIBERAL ARTS",3.2232,"G"
550,450,1000,"LIBERAL ARTS",3.61,"G"
580,720,1300,"ENGINEERING",3.2086,"G"
500,590,1090,"ENGINEERING",2.5942,"G"
620,590,1210,"FINE ARTS",3.6,"G"
650,660,1310,"LIBERAL ARTS",3.6339,"G"
570,530,1100,"COMMUNICATIONS",3.3185,"G"
590,530,1120,"NATURAL SCIENCE",3.5564,"G"
640,530,1170,"NATURAL SCIENCE",2.687,"G"
530,610,1140,"LIBERAL ARTS",2.5491,"G"
550,580,1130,"ENGINEERING",2.6923,"G"
580,740,1320,"BUSINESS",3.0573,"G"
610,720,1330,"NATURAL SCIENCE",2.9519,"G"
550,650,1200,"LIBERAL ARTS",3.1444,"G"
450,510,960,"FINE ARTS",2.9647,"G"
540,690,1230,"ENGINEERING",3.5,"G"
570,570,1140,"NATURAL SCIENCE",2.7345,"G"
660,550,1210,"FINE ARTS",3.5,"G"
750,680,1430,"LIBERAL ARTS",3.7966,"G"
630,630,1260,"BUSINESS",2.9019,"G"
600,590,1190,"LIBERAL ARTS",3.5968,"G"
600,620,1220,"LIBERAL ARTS",2.6571,"G"
480,460,940,"EDUCATION",3.4893,"G"
630,740,1370,"ENGINEERING",3.4726,"G"
650,550,1200,"LIBERAL ARTS",2.9512,"G"
540,510,1050,"NATURAL SCIENCE",3.202,"G"
480,530,1010,"BUSINESS",2.68,"G"
640,500,1140,"LIBERAL ARTS",2.9932,"G"
590,590,1180,"LIBERAL ARTS",3.2127,"G"
610,610,1220,"NATURAL SCIENCE",3.6739,"G"
580,660,1240,"FINE ARTS",3.9583,"G"
630,540,1170,"LIBERAL ARTS",2.6385,"G"
570,630,1200,"BUSINESS",3.5428,"G"
520,540,1060,"LIBERAL ARTS",2.4833,"G"
580,440,1020,"LIBERAL ARTS",3.3984,"G"
660,590,1250,"COMMUNICATIONS",4,"G"
540,600,1140,"LIBERAL ARTS",2.433,"G"
680,660,1340,"ENGINEERING",3.5846,"G"
620,710,1330,"BUSINESS",3.0336,"G"
620,690,1310,"NATURAL SCIENCE",3.6858,"G"
580,550,1130,"LIBERAL ARTS",2.7355,"G"
690,560,1250,"LIBERAL ARTS",3.0344,"G"
600,670,1270,"NATURAL SCIENCE",3.4357,"G"
390,470,860,"LIBERAL ARTS",2.8705,"G"
460,390,850,"LIBERAL ARTS",2.3802,"G"
450,510,960,"EDUCATION",3.054,"G"
770,620,1390,"LIBERAL ARTS",3.116,"G"
650,610,1260,"NATURAL SCIENCE",2.6854,"G"
670,650,1320,"ENGINEERING",4,"G"
480,550,1030,"BUSINESS",3.4065,"G"
710,690,1400,"ENGINEERING",3.4769,"G"
630,610,1240,"NATURAL SCIENCE",3.3962,"G"
600,620,1220,"ENGINEERING",2.5038,"G"
610,610,1220,"NATURAL SCIENCE",3.1792,"G"
650,680,1330,"BUSINESS",3.9285,"G"
640,690,1330,"LIBERAL ARTS",3.3571,"G"
720,670,1390,"COMMUNICATIONS",3.7589,"G"
570,610,1180,"BUSINESS",3.5816,"G"
670,670,1340,"LIBERAL ARTS",3.5826,"G"
650,660,1310,"BUSINESS",3.644,"G"
620,790,1410,"ENGINEERING",4,"G"
530,660,1190,"NATURAL SCIENCE",2.9827,"G"
670,770,1440,"NATURAL SCIENCE",3.031,"G"
680,600,1280,"COMMUNICATIONS",3.584,"G"
510,590,1100,"LIBERAL ARTS",2.1273,"G"
640,560,1200,"NATURAL SCIENCE",2.7777,"G"
500,540,1040,"LIBERAL ARTS",2.8018,"G"
460,540,1000,"COMMUNICATIONS",2.5811,"G"
640,650,1290,"NATURAL SCIENCE",3.8783,"G"
580,590,1170,"NATURAL SCIENCE",2.7572,"G"
800,700,1500,"ENGINEERING",3.3178,"G"
610,690,1300,"ENGINEERING",2.9639,"G"
530,640,1170,"NATURAL SCIENCE",2.5602,"G"
490,490,980,"BUSINESS",2.7363,"G"
700,740,1440,"LIBERAL ARTS",3.2207,"G"
470,510,980,"LIBERAL ARTS",3.0097,"G"
640,610,1250,"ENGINEERING",2.9915,"G"
590,670,1260,"ENGINEERING",3.2905,"G"
590,690,1280,"BUSINESS",3.1318,"G"
570,490,1060,"LIBERAL ARTS",2.7419,"G"
440,490,930,"BUSINESS",3.6814,"G"
640,590,1230,"LIBERAL ARTS",3.1467,"G"
590,560,1150,"COMMUNICATIONS",2.6134,"G"
710,640,1350,"COMMUNICATIONS",3.88,"G"
740,740,1480,"LIBERAL ARTS",3.9734,"G"
720,660,1380,"BUSINESS",3.7461,"G"
530,530,1060,"NATURAL SCIENCE",2.4384,"G"
500,670,1170,"BUSINESS",3.8166,"G"
630,680,1310,"ARCHITECTURE",3.245,"G"
620,580,1200,"FINE ARTS",2.8974,"G"
690,650,1340,"LIBERAL ARTS",3.3464,"G"
600,620,1220,"LIBERAL ARTS",2.1344,"G"
650,640,1290,"LIBERAL ARTS",3,"G"
760,710,1470,"NATURAL SCIENCE",2.8421,"G"
480,590,1070,"LIBERAL ARTS",2.5757,"G"
540,650,1190,"LIBERAL ARTS",2.9879,"G"
560,590,1150,"LIBERAL ARTS",3.0392,"G"
640,710,1350,"LIBERAL ARTS",3.3714,"G"
490,660,1150,"FINE ARTS",2.9795,"G"
720,710,1430,"BUSINESS",3.8715,"G"
630,660,1290,"BUSINESS",3.9754,"G"
690,670,1360,"LIBERAL ARTS",3.7652,"G"
690,640,1330,"NATURAL SCIENCE",3.0909,"G"
540,660,1200,"ENGINEERING",3.4035,"G"
600,670,1270,"LIBERAL ARTS",2.3272,"G"
660,740,1400,"ENGINEERING",3.9126,"G"
580,650,1230,"NATURAL SCIENCE",3.4054,"G"
500,510,1010,"BUSINESS",3.1909,"G"
510,520,1030,"LIBERAL ARTS",3.2758,"G"
680,700,1380,"NATURAL SCIENCE",3.831,"G"
730,660,1390,"LIBERAL ARTS",3.9268,"G"
680,710,1390,"NATURAL SCIENCE",3.5298,"G"
580,610,1190,"LIBERAL ARTS",3.5948,"G"
690,800,1490,"NATURAL SCIENCE",4,"G"
610,520,1130,"LIBERAL ARTS",3.5548,"G"
790,640,1430,"BUSINESS",3.7652,"G"
660,730,1390,"BUSINESS",3.8205,"G"
450,540,990,"COMMUNICATIONS",2.9636,"G"
610,690,1300,"NATURAL SCIENCE",3.6722,"G"
520,560,1080,"LIBERAL ARTS",2.9428,"G"
470,480,950,"LIBERAL ARTS",3.1355,"G"
600,680,1280,"BUSINESS",3.0891,"G"
660,570,1230,"LIBERAL ARTS",3.4838,"G"
550,540,1090,"LIBERAL ARTS",3.063,"G"
640,720,1360,"NATURAL SCIENCE",3.5339,"G"
630,590,1220,"FINE ARTS",3.7403,"G"
750,710,1460,"LIBERAL ARTS",3.0671,"G"
600,620,1220,"ENGINEERING",2.225,"G"
640,590,1230,"BUSINESS",3.3647,"G"
690,750,1440,"ENGINEERING",2.9594,"G"
620,550,1170,"NATURAL SCIENCE",3.7432,"G"
530,680,1210,"NATURAL SCIENCE",3.4166,"G"
750,690,1440,"NATURAL SCIENCE",3.1718,"G"
560,580,1140,"BUSINESS",3.0561,"G"
640,560,1200,"NATURAL SCIENCE",2.8125,"G"
620,570,1190,"LIBERAL ARTS",3.3969,"G"
590,560,1150,"LIBERAL ARTS",2.6785,"G"
620,680,1300,"ENGINEERING",3.2068,"G"
600,610,1210,"BUSINESS",2.7604,"G"
620,640,1260,"NATURAL SCIENCE",2.2054,"G"
640,580,1220,"NATURAL SCIENCE",2.0569,"G"
650,560,1210,"LIBERAL ARTS",2.4957,"G"
640,650,1290,"ENGINEERING",2.9078,"G"
490,480,970,"LIBERAL ARTS",3.1926,"G"
530,620,1150,"BUSINESS",3.1287,"G"
700,740,1440,"BUSINESS",3.7876,"G"
590,560,1150,"NATURAL SCIENCE",3.5045,"G"
750,750,1500,"BUSINESS",3.7446,"G"
470,540,1010,"FINE ARTS",3.123,"G"
510,590,1100,"NATURAL SCIENCE",3.7786,"G"
630,650,1280,"LIBERAL ARTS",2.4421,"G"
540,620,1160,"LIBERAL ARTS",3.4561,"G"
680,680,1360,"NATURAL SCIENCE",3.2181,"G"
670,540,1210,"LIBERAL ARTS",3.55,"G"
560,520,1080,"FINE ARTS",3.2352,"G"
580,570,1150,"COMMUNICATIONS",3.4725,"G"
500,560,1060,"ENGINEERING",2.5161,"G"
690,520,1210,"EDUCATION",3.2935,"G"
380,380,760,"LIBERAL ARTS",2.879,"G"
620,660,1280,"ENGINEERING",3.7021,"G"
510,680,1190,"LIBERAL ARTS",3.1578,"G"
350,460,810,"LIBERAL ARTS",3.184,"G"
620,650,1270,"BUSINESS",3.112,"G"
580,580,1160,"LIBERAL ARTS",2.7545,"G"
400,460,860,"NURSING",3.4586,"G"
470,650,1120,"LIBERAL ARTS",2.8503,"G"
530,520,1050,"LIBERAL ARTS",3.2912,"G"
610,710,1320,"NATURAL SCIENCE",3.2905,"G"
570,520,1090,"LIBERAL ARTS",2.1376,"G"
770,630,1400,"LIBERAL ARTS",3.2792,"G"
620,670,1290,"ENGINEERING",3.9105,"G"
490,510,1000,"LIBERAL ARTS",2.4444,"G"
530,660,1190,"BUSINESS",3.3636,"G"
640,640,1280,"NATURAL SCIENCE",3.088,"G"
500,690,1190,"BUSINESS",2.9,"G"
640,750,1390,"LIBERAL ARTS",3.6934,"G"
600,640,1240,"ENGINEERING",2.5496,"G"
560,700,1260,"BUSINESS",3.5798,"G"
630,750,1380,"ENGINEERING",3.6031,"G"
510,550,1060,"LIBERAL ARTS",2.5955,"G"
550,620,1170,"FINE ARTS",2.6837,"G"
420,570,990,"BUSINESS",3.3366,"G"
670,540,1210,"LIBERAL ARTS",3.5853,"G"
510,580,1090,"NATURAL SCIENCE",2.6567,"G"
510,520,1030,"LIBERAL ARTS",3.421,"G"
450,410,860,"BUSINESS",2.8446,"G"
460,630,1090,"EDUCATION",2.7,"G"
570,560,1130,"NURSING",3.2568,"G"
480,510,990,"LIBERAL ARTS",3.0857,"G"
530,740,1270,"BUSINESS",3.6597,"G"
680,790,1470,"BUSINESS",3.9152,"G"
550,530,1080,"COMMUNICATIONS",2.7522,"G"
610,610,1220,"LIBERAL ARTS",2.5619,"G"
580,630,1210,"LIBERAL ARTS",2.246,"G"
560,540,1100,"LIBERAL ARTS",3.0175,"G"
560,550,1110,"EDUCATION",2.419,"G"
620,610,1230,"NATURAL SCIENCE",3.2786,"G"
620,660,1280,"LIBERAL ARTS",3.1047,"G"
630,610,1240,"NATURAL SCIENCE",3.4957,"G"
690,720,1410,"BUSINESS",3.8986,"G"
520,550,1070,"COMMUNICATIONS",2.9387,"G"
560,580,1140,"LIBERAL ARTS",2.1196,"G"
580,630,1210,"BUSINESS",3.3069,"G"
630,700,1330,"ENGINEERING",2.9084,"G"
650,640,1290,"BUSINESS",4,"G"
610,550,1160,"LIBERAL ARTS",3.491,"G"
560,590,1150,"LIBERAL ARTS",3.5461,"G"
560,560,1120,"LIBERAL ARTS",3.1111,"G"
520,600,1120,"BUSINESS",3.3271,"G"
660,700,1360,"LIBERAL ARTS",2.6824,"G"
630,650,1280,"BUSINESS",3.4056,"G"
520,600,1120,"NATURAL SCIENCE",2.6404,"G"
560,520,1080,"ENGINEERING",3.4603,"G"
520,450,970,"EDUCATION",3.1783,"G"
630,650,1280,"NATURAL SCIENCE",3.549,"G"
530,630,1160,"ENGINEERING",2.8455,"G"
600,610,1210,"ENGINEERING",2.6339,"G"
540,610,1150,"BUSINESS",3.3258,"G"
480,440,920,"NATURAL SCIENCE",3.1842,"G"
500,510,1010,"LIBERAL ARTS",3.3581,"G"
720,720,1440,"COMMUNICATIONS",3.1176,"G"
410,500,910,"COMMUNICATIONS",2.7941,"G"
540,570,1110,"BUSINESS",3.8,"G"
650,620,1270,"ENGINEERING",2.5,"G"
640,700,1340,"BUSINESS",3.6792,"G"
520,580,1100,"NATURAL SCIENCE",3.3846,"G"
630,610,1240,"NATURAL SCIENCE",2.458,"G"
660,620,1280,"COMMUNICATIONS",3.7272,"G"
640,650,1290,"NATURAL SCIENCE",3.7433,"G"
470,450,920,"FINE ARTS",3.7,"G"
580,570,1150,"LIBERAL ARTS",3.1694,"G"
610,540,1150,"NURSING",3.2293,"G"
650,550,1200,"LIBERAL ARTS",3.7115,"G"
590,580,1170,"LIBERAL ARTS",3.4426,"G"
400,540,940,"LIBERAL ARTS",2.7314,"G"
580,610,1190,"LIBERAL ARTS",2.7815,"G"
710,730,1440,"LIBERAL ARTS",3.9349,"G"
590,660,1250,"NATURAL SCIENCE",2.993,"G"
720,660,1380,"LIBERAL ARTS",3.9846,"G"
650,730,1380,"NATURAL SCIENCE",3.9489,"G"
640,650,1290,"NATURAL SCIENCE",3.6583,"G"
460,460,920,"LIBERAL ARTS",3.15,"G"
450,690,1140,"ENGINEERING",3.2992,"G"
430,450,880,"LIBERAL ARTS",2.292,"G"
660,710,1370,"LIBERAL ARTS",3.3703,"G"
670,720,1390,"BUSINESS",3.4018,"G"
670,530,1200,"LIBERAL ARTS",3.1538,"G"
640,550,1190,"LIBERAL ARTS",2.8086,"G"
450,480,930,"COMMUNICATIONS",2.3636,"G"
760,640,1400,"LIBERAL ARTS",3.8571,"G"
690,690,1380,"BUSINESS",3.8928,"G"
470,580,1050,"LIBERAL ARTS",2.4396,"G"
440,650,1090,"NATURAL SCIENCE",2.6356,"G"
660,620,1280,"LIBERAL ARTS",2.969,"G"
600,570,1170,"COMMUNICATIONS",3.46,"G"
610,700,1310,"ENGINEERING",3.0476,"G"
500,670,1170,"ENGINEERING",3.1729,"G"
460,510,970,"EDUCATION",2.1272,"G"
520,630,1150,"LIBERAL ARTS",2.5405,"G"
600,590,1190,"NATURAL SCIENCE",2.9814,"G"
770,640,1410,"BUSINESS",3.4336,"G"
580,540,1120,"LIBERAL ARTS",2.3402,"G"
520,590,1110,"LIBERAL ARTS",3.2842,"G"
590,800,1390,"ENGINEERING",3.8541,"G"
600,770,1370,"LIBERAL ARTS",3.6322,"G"
690,670,1360,"LIBERAL ARTS",3.5973,"G"
710,600,1310,"LIBERAL ARTS",3.7377,"G"
510,480,990,"EDUCATION",3.1195,"G"
510,620,1130,"COMMUNICATIONS",3.4736,"G"
510,610,1120,"LIBERAL ARTS",3.32,"G"
670,800,1470,"ENGINEERING",3.52,"G"
610,650,1260,"NATURAL SCIENCE",3.5771,"G"
700,670,1370,"LIBERAL ARTS",2.9508,"G"
610,630,1240,"LIBERAL ARTS",2.6068,"G"
530,510,1040,"COMMUNICATIONS",2.609,"G"
550,630,1180,"NATURAL SCIENCE",2.8407,"G"
720,650,1370,"ENGINEERING",3.1166,"G"
680,680,1360,"ENGINEERING",3.9473,"G"
590,590,1180,"BUSINESS",3.8095,"G"
680,610,1290,"COMMUNICATIONS",3.0344,"G"
630,540,1170,"LIBERAL ARTS",2.6015,"G"
580,600,1180,"BUSINESS",3.43,"G"
530,640,1170,"LIBERAL ARTS",3.0769,"G"
720,700,1420,"LIBERAL ARTS",3.891,"G"
540,580,1120,"BUSINESS",3.3773,"G"
580,610,1190,"LIBERAL ARTS",2.8666,"G"
680,660,1340,"NATURAL SCIENCE",3.4523,"G"
440,410,850,"COMMUNICATIONS",3.5982,"G"
650,550,1200,"BUSINESS",3.2374,"G"
650,710,1360,"ENGINEERING",3.9296,"G"
580,530,1110,"COMMUNICATIONS",3.0891,"G"
520,580,1100,"LIBERAL ARTS",2.732,"G"
560,630,1190,"BUSINESS",2.5619,"G"
650,590,1240,"LIBERAL ARTS",2.9137,"G"
760,790,1550,"LIBERAL ARTS",3.9464,"G"
580,710,1290,"LIBERAL ARTS",3.2926,"G"
530,650,1180,"ENGINEERING",3.0588,"G"
610,620,1230,"BUSINESS",4,"G"
590,540,1130,"LIBERAL ARTS",3.0701,"G"
560,680,1240,"NATURAL SCIENCE",2.8706,"G"
620,590,1210,"NATURAL SCIENCE",3.282,"G"
530,650,1180,"LIBERAL ARTS",3.3684,"G"
760,630,1390,"LIBERAL ARTS",3.265,"G"
650,680,1330,"ENGINEERING",3.4347,"G"
580,670,1250,"NATURAL SCIENCE",3.2211,"G"
600,690,1290,"BUSINESS",3.8983,"G"
530,480,1010,"COMMUNICATIONS",2.9411,"G"
630,680,1310,"ENGINEERING",3.7062,"G"
720,680,1400,"NATURAL SCIENCE",3.8064,"G"
690,700,1390,"LIBERAL ARTS",3.6373,"G"
800,660,1460,"LIBERAL ARTS",3.9818,"G"
620,660,1280,"LIBERAL ARTS",2.89,"G"
600,550,1150,"COMMUNICATIONS",3.3823,"G"
430,580,1010,"ENGINEERING",2.9703,"G"
580,640,1220,"NATURAL SCIENCE",3.9509,"G"
730,630,1360,"NATURAL SCIENCE",3.1801,"G"
570,670,1240,"BUSINESS",3.7445,"G"
350,320,670,"BUSINESS",2.5762,"G"
510,570,1080,"BUSINESS",3.1868,"G"
530,570,1100,"COMMUNICATIONS",3.5754,"G"
490,420,910,"LIBERAL ARTS",3.1489,"G"
420,530,950,"LIBERAL ARTS",2.0132,"G"
650,770,1420,"ENGINEERING",3.2076,"G"
610,510,1120,"COMMUNICATIONS",3.8543,"G"
590,530,1120,"COMMUNICATIONS",4,"G"
680,680,1360,"LIBERAL ARTS",3.619,"G"
540,550,1090,"LIBERAL ARTS",3.0775,"G"
550,600,1150,"NATURAL SCIENCE",2.3732,"G"
560,610,1170,"NATURAL SCIENCE",3.1941,"G"
420,500,920,"LIBERAL ARTS",2.632,"G"
670,710,1380,"ENGINEERING",3.1463,"G"
640,640,1280,"COMMUNICATIONS",2.7087,"G"
490,540,1030,"ENGINEERING",2.8666,"G"
530,500,1030,"LIBERAL ARTS",2.9596,"G"
490,630,1120,"FINE ARTS",3.6491,"G"
610,640,1250,"LIBERAL ARTS",3.5,"G"
580,630,1210,"NATURAL SCIENCE",2.426,"G"
670,630,1300,"NATURAL SCIENCE",2.6453,"G"
620,570,1190,"FINE ARTS",3.4603,"G"
750,670,1420,"NATURAL SCIENCE",3.7419,"G"
600,550,1150,"NATURAL SCIENCE",3.4657,"G"
580,650,1230,"ENGINEERING",3.169,"G"
670,660,1330,"LIBERAL ARTS",3.0439,"G"
620,540,1160,"LIBERAL ARTS",3.1891,"G"
610,660,1270,"LIBERAL ARTS",2.4375,"G"
500,550,1050,"LIBERAL ARTS",3.0102,"G"
620,640,1260,"LIBERAL ARTS",3.8771,"G"
800,750,1550,"COMMUNICATIONS",3.9318,"G"
650,700,1350,"BUSINESS",3.4574,"G"
690,640,1330,"NATURAL SCIENCE",3.6638,"G"
580,490,1070,"NATURAL SCIENCE",3.2575,"G"
640,730,1370,"ENGINEERING",3.8985,"G"
590,560,1150,"ENGINEERING",3.3787,"G"
540,580,1120,"LIBERAL ARTS",3.6813,"G"
470,500,970,"LIBERAL ARTS",3.0793,"G"
780,720,1500,"ENGINEERING",3.4206,"G"
560,620,1180,"LIBERAL ARTS",3.2551,"G"
580,660,1240,"LIBERAL ARTS",2.2727,"G"
560,640,1200,"BUSINESS",3.5675,"G"
610,650,1260,"BUSINESS",3.1382,"G"
490,530,1020,"NATURAL SCIENCE",3.176,"G"
560,640,1200,"NATURAL SCIENCE",3.4035,"G"
640,600,1240,"NATURAL SCIENCE",3.3496,"G"
720,770,1490,"NATURAL SCIENCE",3.4487,"G"
560,700,1260,"BUSINESS",2.9918,"G"
640,710,1350,"ENGINEERING",3.4634,"G"
500,530,1030,"COMMUNICATIONS",3.6697,"G"
420,450,870,"EDUCATION",2.8773,"G"
440,440,880,"LIBERAL ARTS",2.3203,"G"
610,580,1190,"NATURAL SCIENCE",3.0268,"G"
590,710,1300,"ENGINEERING",3.975,"G"
580,710,1290,"BUSINESS",3.3831,"G"
570,500,1070,"LIBERAL ARTS",2.1785,"G"
630,630,1260,"LIBERAL ARTS",3.2198,"G"
550,600,1150,"NATURAL SCIENCE",2.4907,"G"
690,650,1340,"SOCIAL WORK",3.3797,"G"
530,500,1030,"LIBERAL ARTS",3.3728,"G"
700,750,1450,"BUSINESS",3.5636,"G"
690,630,1320,"LIBERAL ARTS",3.5886,"G"
750,800,1550,"BUSINESS",4,"G"
570,610,1180,"LIBERAL ARTS",2.9268,"G"
610,460,1070,"LIBERAL ARTS",3.4298,"G"
580,570,1150,"NATURAL SCIENCE",2.7857,"G"
720,610,1330,"NATURAL SCIENCE",3.7401,"G"
670,640,1310,"NATURAL SCIENCE",3.6374,"G"
540,580,1120,"NATURAL SCIENCE",3.1652,"G"
670,590,1260,"LIBERAL ARTS",3.6666,"G"
760,750,1510,"NATURAL SCIENCE",2.7852,"G"
620,650,1270,"NATURAL SCIENCE",3.6989,"G"
650,690,1340,"ENGINEERING",3.3445,"G"
480,660,1140,"LIBERAL ARTS",2.7843,"G"
560,630,1190,"LIBERAL ARTS",2.647,"G"
510,620,1130,"NATURAL SCIENCE",3.0327,"G"
480,450,930,"LIBERAL ARTS",3.1398,"G"
750,670,1420,"ENGINEERING",3.7197,"G"
610,680,1290,"LIBERAL ARTS",3.7127,"G"
560,620,1180,"ENGINEERING",3.6875,"G"
610,660,1270,"ENGINEERING",3.6535,"G"
470,560,1030,"BUSINESS",2.7586,"G"
670,660,1330,"BUSINESS",2.6525,"G"
610,690,1300,"FINE ARTS",3.0087,"G"
690,790,1480,"NATURAL SCIENCE",3.9779,"G"
770,740,1510,"LIBERAL ARTS",3.7028,"G"
630,660,1290,"EDUCATION",3.7684,"G"
650,770,1420,"NATURAL SCIENCE",3.8698,"G"
600,580,1180,"LIBERAL ARTS",3.3113,"G"
440,600,1040,"LIBERAL ARTS",3.2932,"G"
600,750,1350,"LIBERAL ARTS",3.139,"G"
430,430,860,"ENGINEERING",2.9071,"G"
570,640,1210,"LIBERAL ARTS",2.3356,"G"
640,550,1190,"LIBERAL ARTS",2.1739,"G"
490,490,980,"NATURAL SCIENCE",2.6406,"G"
610,610,1220,"ENGINEERING",2.1048,"G"
510,560,1070,"BUSINESS",2.5798,"G"
750,550,1300,"LIBERAL ARTS",3.8602,"G"
630,680,1310,"BUSINESS",2.1239,"G"
580,550,1130,"COMMUNICATIONS",3.5961,"G"
450,480,930,"LIBERAL ARTS",3.504,"G"
670,740,1410,"NATURAL SCIENCE",3,"G"
710,690,1400,"LIBERAL ARTS",3.5185,"G"
540,530,1070,"BUSINESS",2.3947,"G"
510,580,1090,"LIBERAL ARTS",2.5895,"G"
660,790,1450,"ENGINEERING",3.7164,"G"
640,640,1280,"LIBERAL ARTS",2.8421,"G"
600,790,1390,"COMMUNICATIONS",3.4857,"G"
600,590,1190,"NATURAL SCIENCE",3.6808,"G"
630,580,1210,"LIBERAL ARTS",2.923,"G"
780,660,1440,"COMMUNICATIONS",3.5151,"G"
750,700,1450,"ENGINEERING",3.051,"G"
430,500,930,"ENGINEERING",2.6937,"G"
420,410,830,"COMMUNICATIONS",3.375,"G"
520,540,1060,"LIBERAL ARTS",3.4615,"G"
500,790,1290,"ENGINEERING",3.023,"G"
800,730,1530,"COMMUNICATIONS",3.8222,"G"
770,800,1570,"NATURAL SCIENCE",3.7338,"G"
670,700,1370,"BUSINESS",3.23,"G"
500,530,1030,"LIBERAL ARTS",2.1,"G"
600,650,1250,"LIBERAL ARTS",3.3737,"G"
730,590,1320,"COMMUNICATIONS",3.1652,"G"
800,710,1510,"COMMUNICATIONS",2.6588,"G"
590,590,1180,"ENGINEERING",3.7815,"G"
570,600,1170,"FINE ARTS",3.1111,"G"
560,690,1250,"NATURAL SCIENCE",2.7602,"G"
650,650,1300,"LIBERAL ARTS",3.6923,"G"
560,490,1050,"LIBERAL ARTS",3.2142,"G"
540,550,1090,"LIBERAL ARTS",2.7588,"G"
690,790,1480,"BUSINESS",2.878,"G"
720,660,1380,"NATURAL SCIENCE",2.823,"G"
580,630,1210,"BUSINESS",2.9523,"G"
530,510,1040,"LIBERAL ARTS",2.9705,"G"
700,590,1290,"LIBERAL ARTS",3.9024,"G"
600,580,1180,"LIBERAL ARTS",3.6693,"G"
640,560,1200,"LIBERAL ARTS",3.1666,"G"
710,800,1510,"NATURAL SCIENCE",3.4827,"G"
580,690,1270,"BUSINESS",3.9237,"G"
730,740,1470,"LIBERAL ARTS",3.4277,"G"
390,430,820,"LIBERAL ARTS",2.4121,"G"
540,630,1170,"BUSINESS",3.2818,"G"
540,670,1210,"ENGINEERING",2.6356,"G"
720,710,1430,"LIBERAL ARTS",2.7435,"G"
510,520,1030,"NATURAL SCIENCE",3.0687,"G"
690,610,1300,"ENGINEERING",3.6339,"G"
590,560,1150,"NATURAL SCIENCE",2.5462,"G"
580,790,1370,"NATURAL SCIENCE",3.3879,"G"
590,740,1330,"NATURAL SCIENCE",3.7121,"G"
570,470,1040,"COMMUNICATIONS",2.6057,"G"
690,710,1400,"LIBERAL ARTS",3.584,"G"
660,640,1300,"LIBERAL ARTS",3.7913,"G"
560,640,1200,"ENGINEERING",2.875,"G"
570,690,1260,"NATURAL SCIENCE",2.7894,"G"
570,510,1080,"LIBERAL ARTS",2.9032,"G"
610,570,1180,"BUSINESS",3.1333,"G"
640,530,1170,"EDUCATION",3.9117,"G"
670,730,1400,"BUSINESS",3.3508,"G"
610,630,1240,"COMMUNICATIONS",3.6915,"G"
660,550,1210,"LIBERAL ARTS",3.7079,"G"
730,690,1420,"NATURAL SCIENCE",3.0598,"G"
500,510,1010,"LIBERAL ARTS",2.8448,"G"
730,770,1500,"NATURAL SCIENCE",3.416,"G"
580,680,1260,"NATURAL SCIENCE",3.2061,"G"
570,560,1130,"COMMUNICATIONS",3.4226,"G"
520,640,1160,"LIBERAL ARTS",3.3939,"G"
530,590,1120,"LIBERAL ARTS",2.661,"G"
450,490,940,"ENGINEERING",2.4393,"G"
490,620,1110,"BUSINESS",3.2429,"G"
550,490,1040,"EDUCATION",2.4369,"G"
410,410,820,"LIBERAL ARTS",2.7567,"G"
600,600,1200,"LIBERAL ARTS",2.8444,"G"
530,620,1150,"BUSINESS",3.125,"G"
600,720,1320,"BUSINESS",3.8496,"G"
530,480,1010,"LIBERAL ARTS",2.309,"G"
500,580,1080,"ENGINEERING",2.2214,"G"
730,670,1400,"COMMUNICATIONS",4,"G"
600,640,1240,"NATURAL SCIENCE",3.0857,"G"
600,590,1190,"LIBERAL ARTS",2.6371,"G"
660,650,1310,"COMMUNICATIONS",3.3258,"G"
610,670,1280,"COMMUNICATIONS",3.3955,"G"
700,650,1350,"BUSINESS",3.5179,"G"
520,580,1100,"NATURAL SCIENCE",3.2592,"G"
500,460,960,"COMMUNICATIONS",3.1632,"G"
660,650,1310,"NATURAL SCIENCE",3.0943,"G"
590,510,1100,"NATURAL SCIENCE",2.6554,"G"
650,610,1260,"LIBERAL ARTS",3.0625,"G"
690,690,1380,"FINE ARTS",3.6492,"G"
550,680,1230,"LIBERAL ARTS",2.5762,"G"
610,660,1270,"COMMUNICATIONS",3.5581,"G"
790,630,1420,"BUSINESS",3.6818,"G"
600,680,1280,"LIBERAL ARTS",3.3225,"G"
670,780,1450,"NATURAL SCIENCE",3.7364,"G"
650,680,1330,"NATURAL SCIENCE",2.8776,"G"
590,590,1180,"COMMUNICATIONS",3.4363,"G"
510,570,1080,"ENGINEERING",2.7658,"G"
680,660,1340,"BUSINESS",3.5928,"G"
590,670,1260,"BUSINESS",3.6837,"G"
720,730,1450,"LIBERAL ARTS",3.9019,"G"
760,790,1550,"BUSINESS",3.7265,"G"
520,470,990,"LIBERAL ARTS",2.8303,"G"
580,650,1230,"EDUCATION",3.5963,"G"
570,680,1250,"ENGINEERING",3.9318,"G"
560,540,1100,"LIBERAL ARTS",2.918,"G"
560,640,1200,"LIBERAL ARTS",3.5897,"G"
630,610,1240,"NATURAL SCIENCE",3.4573,"G"
580,600,1180,"BUSINESS",3.4876,"G"
660,590,1250,"LIBERAL ARTS",3.8039,"G"
530,550,1080,"NATURAL SCIENCE",2.4154,"G"
760,690,1450,"LIBERAL ARTS",3.5514,"G"
690,580,1270,"LIBERAL ARTS",2.1733,"G"
450,670,1120,"ENGINEERING",2.217,"G"
440,520,960,"LIBERAL ARTS",3.2291,"G"
490,490,980,"COMMUNICATIONS",3.0109,"G"
570,680,1250,"NATURAL SCIENCE",3.3277,"G"
620,590,1210,"LIBERAL ARTS",3.8823,"G"
560,650,1210,"EDUCATION",2.2804,"G"
540,440,980,"LIBERAL ARTS",2.2857,"G"
650,630,1280,"LIBERAL ARTS",3.6528,"G"
730,790,1520,"ENGINEERING",3.9358,"G"
450,420,870,"EDUCATION",2.3057,"G"
560,690,1250,"BUSINESS",2.6216,"G"
440,480,920,"LIBERAL ARTS",3.2288,"G"
540,720,1260,"ENGINEERING",2.4358,"G"
540,690,1230,"BUSINESS",3.252,"G"
560,630,1190,"LIBERAL ARTS",3.4453,"G"
510,550,1060,"LIBERAL ARTS",3.3559,"G"
720,630,1350,"NATURAL SCIENCE",3.188,"G"
770,740,1510,"NATURAL SCIENCE",3.3282,"G"
570,630,1200,"BUSINESS",3.835,"G"
560,580,1140,"EDUCATION",3.5937,"G"
670,600,1270,"LIBERAL ARTS",3.3274,"G"
510,500,1010,"LIBERAL ARTS",3.1205,"G"
500,470,970,"LIBERAL ARTS",2.3555,"G"
720,690,1410,"LIBERAL ARTS",3.5483,"G"
570,560,1130,"LIBERAL ARTS",2.9622,"G"
600,670,1270,"LIBERAL ARTS",2.8644,"G"
800,590,1390,"FINE ARTS",3.9177,"G"
680,560,1240,"FINE ARTS",3.4214,"G"
750,650,1400,"LIBERAL ARTS",4,"G"
500,550,1050,"LIBERAL ARTS",3.3793,"G"
580,790,1370,"ENGINEERING",3.9469,"G"
460,590,1050,"LIBERAL ARTS",2.2704,"G"
640,580,1220,"NATURAL SCIENCE",2.7747,"G"
540,630,1170,"NATURAL SCIENCE",3.6929,"G"
730,630,1360,"FINE ARTS",3.8235,"G"
460,480,940,"BUSINESS",3.0693,"G"
470,560,1030,"LIBERAL ARTS",2.1513,"G"
540,600,1140,"BUSINESS",3.4642,"G"
680,590,1270,"NATURAL SCIENCE",3.7384,"G"
640,770,1410,"LIBERAL ARTS",3.6956,"G"
650,710,1360,"ENGINEERING",3.6666,"G"
600,530,1130,"NATURAL SCIENCE",3.3396,"G"
610,610,1220,"FINE ARTS",3.0612,"G"
600,610,1210,"ENGINEERING",3.5273,"G"
470,590,1060,"NATURAL SCIENCE",3.2807,"G"
570,650,1220,"BUSINESS",3.4336,"G"
460,530,990,"LIBERAL ARTS",3.5794,"G"
620,510,1130,"COMMUNICATIONS",3.4105,"G"
470,490,960,"LIBERAL ARTS",3.2075,"G"
540,470,1010,"LIBERAL ARTS",2.8888,"G"
480,660,1140,"BUSINESS",3.8018,"G"
420,600,1020,"LIBERAL ARTS",3.202,"G"
630,660,1290,"EDUCATION",3.9545,"G"
760,670,1430,"BUSINESS",3.9318,"G"
470,590,1060,"NATURAL SCIENCE",2.9189,"G"
500,510,1010,"LIBERAL ARTS",3.8352,"G"
530,520,1050,"LIBERAL ARTS",3.2991,"G"
590,660,1250,"BUSINESS",3.542,"G"
720,680,1400,"BUSINESS",3.8934,"G"
530,580,1110,"NATURAL SCIENCE",2.1562,"G"
660,650,1310,"BUSINESS",3.4402,"G"
660,550,1210,"COMMUNICATIONS",3.4567,"G"
460,570,1030,"LIBERAL ARTS",3.2446,"G"
720,710,1430,"LIBERAL ARTS",3.7378,"G"
630,770,1400,"ENGINEERING",3.3125,"G"
710,620,1330,"NATURAL SCIENCE",3.752,"G"
670,490,1160,"EDUCATION",2.9062,"G"
600,700,1300,"BUSINESS",3.4356,"G"
510,540,1050,"LIBERAL ARTS",2.379,"G"
670,620,1290,"BUSINESS",3.5877,"G"
610,660,1270,"ENGINEERING",3.3089,"G"
620,600,1220,"LIBERAL ARTS",2.5046,"G"
710,670,1380,"COMMUNICATIONS",3.2705,"G"
490,660,1150,"ENGINEERING",3.9464,"G"
630,560,1190,"COMMUNICATIONS",3.7669,"G"
520,530,1050,"BUSINESS",3.3861,"G"
620,660,1280,"NATURAL SCIENCE",2.888,"G"
630,590,1220,"LIBERAL ARTS",3.7368,"G"
630,620,1250,"BUSINESS",3.752,"G"
460,580,1040,"LIBERAL ARTS",3.27,"G"
570,690,1260,"NATURAL SCIENCE",3.35,"G"
630,610,1240,"LIBERAL ARTS",2.6279,"G"
580,530,1110,"LIBERAL ARTS",3.0666,"G"
490,520,1010,"LIBERAL ARTS",2.4452,"G"
530,620,1150,"BUSINESS",3.2966,"G"
480,600,1080,"NATURAL SCIENCE",3.2869,"G"
490,480,970,"NATURAL SCIENCE",2.3009,"G"
730,690,1420,"LIBERAL ARTS",2.8839,"G"
640,650,1290,"LIBERAL ARTS",3.0151,"G"
560,730,1290,"ENGINEERING",2.8181,"G"
790,760,1550,"LIBERAL ARTS",2.9134,"G"
610,590,1200,"COMMUNICATIONS",2.977,"G"
610,600,1210,"LIBERAL ARTS",3.0958,"G"
590,510,1100,"LIBERAL ARTS",2.5086,"G"
600,700,1300,"NATURAL SCIENCE",3.2647,"G"
580,600,1180,"ENGINEERING",3.1102,"G"
800,670,1470,"COMMUNICATIONS",3.25,"G"
700,800,1500,"ENGINEERING",3.8467,"G"
530,570,1100,"LIBERAL ARTS",3.6559,"G"
500,620,1120,"LIBERAL ARTS",3.6785,"G"
560,560,1120,"LIBERAL ARTS",2.921,"G"
650,630,1280,"ENGINEERING",3.2944,"G"
630,630,1260,"NATURAL SCIENCE",2.8359,"G"
540,530,1070,"EDUCATION",3.1349,"G"
610,690,1300,"ENGINEERING",2.8869,"G"
540,600,1140,"NATURAL SCIENCE",3.116,"G"
620,630,1250,"COMMUNICATIONS",3.568,"G"
590,540,1130,"LIBERAL ARTS",3.0438,"G"
590,640,1230,"LIBERAL ARTS",3.1271,"G"
460,470,930,"COMMUNICATIONS",3.1325,"G"
520,640,1160,"LIBERAL ARTS",2.75,"G"
630,760,1390,"BUSINESS",2.1849,"G"
640,570,1210,"LIBERAL ARTS",2.8623,"G"
670,770,1440,"ENGINEERING",3.826,"G"
670,720,1390,"LIBERAL ARTS",3.6666,"G"
500,540,1040,"NATURAL SCIENCE",3.7304,"G"
490,630,1120,"LIBERAL ARTS",2.9203,"G"
500,580,1080,"LIBERAL ARTS",3.1354,"G"
560,640,1200,"ENGINEERING",3.2847,"G"
520,610,1130,"LIBERAL ARTS",2.7874,"G"
630,630,1260,"NATURAL SCIENCE",3.3949,"G"
480,570,1050,"LIBERAL ARTS",3.2187,"G"
640,800,1440,"ENGINEERING",3.8267,"G"
770,730,1500,"NATURAL SCIENCE",3.4077,"G"
610,620,1230,"LIBERAL ARTS",3.5495,"G"
700,790,1490,"LIBERAL ARTS",3.9821,"G"
640,710,1350,"LIBERAL ARTS",3.1623,"G"
530,510,1040,"BUSINESS",3.116,"G"
580,740,1320,"NATURAL SCIENCE",3.5126,"G"
610,610,1220,"NATURAL SCIENCE",3.4519,"G"
560,670,1230,"BUSINESS",3.0176,"G"
530,670,1200,"ENGINEERING",2.8811,"G"
640,590,1230,"LIBERAL ARTS",3.2457,"G"
580,630,1210,"SOCIAL WORK",2.5934,"G"
540,520,1060,"LIBERAL ARTS",3.2038,"G"
620,660,1280,"BUSINESS",3.2037,"G"
580,560,1140,"LIBERAL ARTS",3.3392,"G"
730,590,1320,"BUSINESS",3.3949,"G"
750,710,1460,"LIBERAL ARTS",3.6095,"G"
570,580,1150,"LIBERAL ARTS",2.9512,"G"
380,590,970,"BUSINESS",3.5086,"G"
660,620,1280,"LIBERAL ARTS",3.7903,"G"
600,550,1150,"COMMUNICATIONS",3.1595,"G"
650,560,1210,"LIBERAL ARTS",3.4718,"G"
710,710,1420,"ARCHITECTURE",3.4197,"G"
570,620,1190,"EDUCATION",3.3033,"G"
670,650,1320,"ENGINEERING",3.7163,"G"
600,650,1250,"LIBERAL ARTS",2.2857,"G"
590,560,1150,"COMMUNICATIONS",2.9745,"G"
440,520,960,"NATURAL SCIENCE",3.3135,"G"
540,470,1010,"NURSING",2.8416,"G"
580,630,1210,"LIBERAL ARTS",3.1683,"G"
630,580,1210,"NATURAL SCIENCE",2.9579,"G"
720,680,1400,"ENGINEERING",2.8666,"G"
600,610,1210,"LIBERAL ARTS",2.7578,"G"
480,550,1030,"LIBERAL ARTS",3.3688,"G"
540,490,1030,"NURSING",3.1932,"G"
610,670,1280,"NATURAL SCIENCE",3.3859,"G"
660,690,1350,"LIBERAL ARTS",3.5909,"G"
570,730,1300,"ENGINEERING",3.2847,"G"
700,780,1480,"NATURAL SCIENCE",3.2051,"G"
580,590,1170,"LIBERAL ARTS",3.8369,"G"
520,510,1030,"NATURAL SCIENCE",3.0819,"G"
640,670,1310,"ENGINEERING",3.4818,"G"
610,540,1150,"LIBERAL ARTS",3.7247,"G"
580,560,1140,"LIBERAL ARTS",3.3297,"G"
560,530,1090,"LIBERAL ARTS",3.1013,"G"
750,720,1470,"BUSINESS",3.6511,"G"
570,750,1320,"NATURAL SCIENCE",3.2419,"G"
520,560,1080,"ENGINEERING",3.24,"G"
540,670,1210,"NATURAL SCIENCE",2.7685,"G"
510,690,1200,"LIBERAL ARTS",2.4586,"G"
700,720,1420,"BUSINESS",3.8434,"G"
620,740,1360,"BUSINESS",3.7956,"G"
560,520,1080,"LIBERAL ARTS",3.9166,"G"
550,690,1240,"LIBERAL ARTS",3.289,"G"
540,700,1240,"NATURAL SCIENCE",2.8846,"G"
670,580,1250,"BUSINESS",2.9909,"G"
690,580,1270,"BUSINESS",2.6435,"G"
620,690,1310,"COMMUNICATIONS",3.5846,"G"
650,720,1370,"FINE ARTS",3.0854,"G"
530,490,1020,"LIBERAL ARTS",2.81,"G"
530,620,1150,"LIBERAL ARTS",3.1451,"G"
620,580,1200,"ENGINEERING",2.0404,"G"
480,370,850,"LIBERAL ARTS",3.63,"G"
670,690,1360,"BUSINESS",3.5164,"G"
650,620,1270,"LIBERAL ARTS",2.7246,"G"
640,740,1380,"NATURAL SCIENCE",3.9058,"G"
660,560,1220,"LIBERAL ARTS",3.7905,"G"
630,600,1230,"LIBERAL ARTS",3.0123,"G"
800,790,1590,"NATURAL SCIENCE",3.8809,"G"
600,530,1130,"COMMUNICATIONS",3.7857,"G"
570,520,1090,"NATURAL SCIENCE",2.3673,"G"
740,670,1410,"BUSINESS",3.7822,"G"
530,680,1210,"LIBERAL ARTS",2.807,"G"
800,710,1510,"LIBERAL ARTS",3.336,"G"
750,720,1470,"NATURAL SCIENCE",3.8174,"G"
510,540,1050,"LIBERAL ARTS",3.2589,"G"
660,610,1270,"FINE ARTS",3.7577,"G"
570,660,1230,"ENGINEERING",2.9677,"G"
570,700,1270,"COMMUNICATIONS",3.2846,"G"
470,520,990,"LIBERAL ARTS",2.8611,"G"
560,550,1110,"NATURAL SCIENCE",3.5568,"G"
530,510,1040,"NATURAL SCIENCE",3.2429,"G"
540,620,1160,"NATURAL SCIENCE",3.5572,"G"
710,800,1510,"NATURAL SCIENCE",3.2307,"G"
430,450,880,"BUSINESS",2.8913,"G"
600,590,1190,"LIBERAL ARTS",2.4965,"G"
800,640,1440,"BUSINESS",3.7,"G"
530,540,1070,"NATURAL SCIENCE",3.1071,"G"
620,710,1330,"FINE ARTS",3.5327,"G"
570,640,1210,"COMMUNICATIONS",3.2828,"G"
610,550,1160,"LIBERAL ARTS",3.042,"G"
610,650,1260,"NATURAL SCIENCE",3.7768,"G"
570,700,1270,"ENGINEERING",2.8287,"G"
480,420,900,"COMMUNICATIONS",2.8717,"G"
560,590,1150,"ENGINEERING",2.8979,"G"
580,540,1120,"LIBERAL ARTS",2.9855,"G"
510,560,1070,"BUSINESS",3.2038,"G"
650,740,1390,"NATURAL SCIENCE",3.4716,"G"
760,800,1560,"NATURAL SCIENCE",3.862,"G"
630,660,1290,"NATURAL SCIENCE",3.2521,"G"
570,640,1210,"NATURAL SCIENCE",3.5294,"G"
600,720,1320,"NATURAL SCIENCE",3.8333,"G"
570,530,1100,"LIBERAL ARTS",3.3367,"G"
570,620,1190,"LIBERAL ARTS",3.6785,"G"
550,620,1170,"LIBERAL ARTS",3.6036,"G"
600,610,1210,"ENGINEERING",3.5739,"G"
570,660,1230,"LIBERAL ARTS",3.0573,"G"
590,790,1380,"ENGINEERING",3.6588,"G"
660,590,1250,"BUSINESS",3.7653,"G"
470,590,1060,"LIBERAL ARTS",3.0176,"G"
720,770,1490,"LIBERAL ARTS",3.9527,"G"
520,650,1170,"LIBERAL ARTS",2.6017,"G"
590,540,1130,"NURSING",3.1965,"G"
620,550,1170,"LIBERAL ARTS",2.7572,"G"
540,580,1120,"ENGINEERING",2.4375,"G"
600,500,1100,"NATURAL SCIENCE",2.805,"G"
580,590,1170,"NATURAL SCIENCE",3.3211,"G"
580,640,1220,"NATURAL SCIENCE",3.2347,"G"
650,610,1260,"NATURAL SCIENCE",2.8461,"G"
720,640,1360,"LIBERAL ARTS",3.7,"G"
440,410,850,"LIBERAL ARTS",2.6141,"G"
530,510,1040,"NATURAL SCIENCE",2.4765,"G"
590,510,1100,"LIBERAL ARTS",2.4424,"G"
570,680,1250,"NATURAL SCIENCE",3.9242,"G"
510,620,1130,"ENGINEERING",3.1944,"G"
690,670,1360,"COMMUNICATIONS",3.9479,"G"
620,710,1330,"LIBERAL ARTS",3.1891,"G"
620,680,1300,"NATURAL SCIENCE",2.8555,"G"
470,540,1010,"NATURAL SCIENCE",2.9295,"G"
710,630,1340,"BUSINESS",3.6632,"G"
450,460,910,"LIBERAL ARTS",2.8435,"G"
650,610,1260,"LIBERAL ARTS",3.3508,"G"
640,670,1310,"FINE ARTS",3.909,"G"
450,520,970,"ENGINEERING",3.0357,"G"
590,610,1200,"NATURAL SCIENCE",3.5412,"G"
680,710,1390,"FINE ARTS",2.9635,"G"
610,720,1330,"NATURAL SCIENCE",3.1631,"G"
710,630,1340,"ENGINEERING",3.8264,"G"
570,600,1170,"BUSINESS",3.088,"G"
580,590,1170,"NATURAL SCIENCE",2.6171,"G"
650,600,1250,"NATURAL SCIENCE",3.4833,"G"
570,590,1160,"BUSINESS",2.8921,"G"
600,570,1170,"NURSING",4,"G"
700,710,1410,"NATURAL SCIENCE",3.7126,"G"
590,580,1170,"BUSINESS",3.0583,"G"
520,640,1160,"ENGINEERING",3.2477,"G"
640,700,1340,"NATURAL SCIENCE",3.7795,"G"
630,640,1270,"NATURAL SCIENCE",3.6489,"G"
620,590,1210,"COMMUNICATIONS",3.3925,"G"
640,540,1180,"LIBERAL ARTS",2.7731,"G"
550,580,1130,"LIBERAL ARTS",3.1058,"G"
490,590,1080,"NATURAL SCIENCE",3.2222,"G"
750,660,1410,"LIBERAL ARTS",3.3203,"G"
510,440,950,"LIBERAL ARTS",2.9084,"G"
660,720,1380,"LIBERAL ARTS",3.304,"G"
550,460,1010,"FINE ARTS",3,"G"
640,710,1350,"ENGINEERING",3.0957,"G"
650,520,1170,"LIBERAL ARTS",2.9642,"G"
610,690,1300,"ENGINEERING",2.8714,"G"
630,690,1320,"LIBERAL ARTS",3.2032,"G"
590,560,1150,"NATURAL SCIENCE",3,"G"
500,660,1160,"NATURAL SCIENCE",2.0729,"G"
600,620,1220,"ENGINEERING",2.406,"G"
580,650,1230,"NATURAL SCIENCE",3.3442,"G"
570,580,1150,"LIBERAL ARTS",3.1875,"G"
640,560,1200,"NATURAL SCIENCE",3.7724,"G"
630,700,1330,"LIBERAL ARTS",3.7551,"G"
540,480,1020,"LIBERAL ARTS",2.27,"G"
660,610,1270,"COMMUNICATIONS",3.6146,"G"
600,560,1160,"LIBERAL ARTS",2.8244,"G"
510,430,940,"LIBERAL ARTS",2.7205,"G"
550,560,1110,"FINE ARTS",3.4123,"G"
640,520,1160,"LIBERAL ARTS",2.6428,"G"
560,490,1050,"COMMUNICATIONS",3.3333,"G"
630,660,1290,"BUSINESS",3.0638,"G"
650,520,1170,"LIBERAL ARTS",3.7338,"G"
660,730,1390,"BUSINESS",3.8604,"G"
470,520,990,"LIBERAL ARTS",2.4818,"G"
680,690,1370,"NATURAL SCIENCE",3.3217,"G"
800,790,1590,"BUSINESS",4,"G"
650,750,1400,"ENGINEERING",3.619,"G"
440,420,860,"COMMUNICATIONS",2.6635,"G"
560,590,1150,"BUSINESS",3.3716,"G"
470,550,1020,"LIBERAL ARTS",2.6349,"G"
730,630,1360,"NATURAL SCIENCE",2.3834,"G"
500,540,1040,"LIBERAL ARTS",2.3106,"G"
510,550,1060,"ENGINEERING",2.7226,"G"
710,670,1380,"BUSINESS",3.6,"G"
510,710,1220,"BUSINESS",3.1612,"G"
650,700,1350,"BUSINESS",3.5576,"G"
560,520,1080,"LIBERAL ARTS",3.5403,"G"
800,790,1590,"NATURAL SCIENCE",3.76,"G"
680,690,1370,"NATURAL SCIENCE",3.2307,"G"
680,600,1280,"COMMUNICATIONS",3.164,"G"
730,700,1430,"ARCHITECTURE",3.0268,"G"
610,580,1190,"LIBERAL ARTS",2.602,"G"
570,630,1200,"LIBERAL ARTS",3.31,"G"
590,620,1210,"NATURAL SCIENCE",2.8365,"G"
530,580,1110,"NATURAL SCIENCE",2.628,"G"
500,590,1090,"EDUCATION",3.163,"G"
680,680,1360,"LIBERAL ARTS",4,"G"
520,520,1040,"NATURAL SCIENCE",2.7765,"G"
490,540,1030,"ENGINEERING",2.6269,"G"
520,620,1140,"LIBERAL ARTS",3.9022,"G"
640,680,1320,"LIBERAL ARTS",3.5677,"G"
520,500,1020,"NATURAL SCIENCE",2.5603,"G"
500,550,1050,"LIBERAL ARTS",2.8118,"G"
700,640,1340,"BUSINESS",3.8157,"G"
560,640,1200,"ENGINEERING",2.3223,"G"
600,770,1370,"ENGINEERING",3.0388,"G"
580,620,1200,"BUSINESS",3.5181,"G"
650,700,1350,"NATURAL SCIENCE",2.8225,"G"
370,360,730,"COMMUNICATIONS",2.7466,"G"
450,500,950,"LIBERAL ARTS",3.4929,"G"
400,480,880,"NURSING",2.6825,"G"
520,640,1160,"BUSINESS",2.6933,"G"
660,560,1220,"EDUCATION",3.2352,"G"
510,560,1070,"BUSINESS",3.4444,"G"
600,600,1200,"NATURAL SCIENCE",3.3925,"G"
660,630,1290,"LIBERAL ARTS",3.5433,"G"
670,720,1390,"NATURAL SCIENCE",3.3985,"G"
710,670,1380,"LIBERAL ARTS",3.5328,"G"
540,680,1220,"BUSINESS",3.8442,"G"
510,620,1130,"ENGINEERING",3.6721,"G"
530,540,1070,"EDUCATION",2.0236,"G"
620,590,1210,"LIBERAL ARTS",2.5744,"G"
630,650,1280,"ENGINEERING",2.9024,"G"
710,740,1450,"BUSINESS",3.2285,"G"
580,590,1170,"LIBERAL ARTS",2.4573,"G"
710,760,1470,"BUSINESS",3.7692,"G"
430,470,900,"NATURAL SCIENCE",3.0089,"G"
310,340,650,"EDUCATION",2.3543,"G"
590,600,1190,"BUSINESS",2.3666,"G"
740,570,1310,"LIBERAL ARTS",3.5217,"G"
680,610,1290,"FINE ARTS",3.4388,"G"
580,670,1250,"BUSINESS",3.5858,"G"
620,700,1320,"BUSINESS",3.5596,"G"
650,640,1290,"ENGINEERING",3.712,"G"
680,740,1420,"NATURAL SCIENCE",3.7348,"G"
560,590,1150,"NATURAL SCIENCE",2.9,"G"
680,670,1350,"COMMUNICATIONS",3.8778,"G"
530,620,1150,"COMMUNICATIONS",3.5769,"G"
540,610,1150,"LIBERAL ARTS",2.4629,"G"
510,630,1140,"ENGINEERING",3.0675,"G"
530,530,1060,"LIBERAL ARTS",2.4666,"G"
800,650,1450,"BUSINESS",3.9469,"G"
480,490,970,"NURSING",2.756,"G"
560,570,1130,"ENGINEERING",3.9478,"G"
450,560,1010,"BUSINESS",3.2867,"G"
600,520,1120,"LIBERAL ARTS",2.6476,"G"
540,720,1260,"LIBERAL ARTS",2.7706,"G"
570,710,1280,"ENGINEERING",3.844,"G"
620,630,1250,"NATURAL SCIENCE",3.1619,"G"
630,800,1430,"NATURAL SCIENCE",2.0333,"G"
470,620,1090,"LIBERAL ARTS",2.8201,"G"
640,430,1070,"COMMUNICATIONS",2.1804,"G"
560,690,1250,"ENGINEERING",2.7007,"G"
590,630,1220,"NATURAL SCIENCE",3.8521,"G"
610,690,1300,"NATURAL SCIENCE",3.2196,"G"
430,710,1140,"NATURAL SCIENCE",3.9393,"G"
570,710,1280,"NATURAL SCIENCE",3.4796,"G"
570,680,1250,"ENGINEERING",3.4344,"G"
620,640,1260,"ENGINEERING",2.3941,"G"
450,480,930,"BUSINESS",2.7984,"G"
460,560,1020,"LIBERAL ARTS",3.3804,"G"
740,670,1410,"LIBERAL ARTS",3.0661,"G"
650,760,1410,"ENGINEERING",3.8914,"G"
560,590,1150,"BUSINESS",3.1415,"G"
590,560,1150,"LIBERAL ARTS",3.2298,"G"
500,600,1100,"BUSINESS",3.1553,"G"
480,420,900,"BUSINESS",3.0973,"G"
670,630,1300,"LIBERAL ARTS",2.8316,"G"
490,680,1170,"NATURAL SCIENCE",3.3846,"G"
580,590,1170,"LIBERAL ARTS",3.6037,"G"
530,610,1140,"NATURAL SCIENCE",2.9696,"G"
730,690,1420,"BUSINESS",4,"G"
630,660,1290,"ENGINEERING",2.7364,"G"
700,640,1340,"LIBERAL ARTS",3.4059,"G"
580,640,1220,"LIBERAL ARTS",3.8536,"G"
510,590,1100,"NATURAL SCIENCE",3.5982,"G"
590,620,1210,"COMMUNICATIONS",3.5368,"G"
650,750,1400,"LIBERAL ARTS",3.7669,"G"
570,630,1200,"LIBERAL ARTS",2.923,"G"
640,670,1310,"COMMUNICATIONS",3.88,"G"
560,660,1220,"LIBERAL ARTS",2.9133,"G"
530,610,1140,"NATURAL SCIENCE",2.9009,"G"
560,650,1210,"BUSINESS",2.2982,"G"
480,510,990,"LIBERAL ARTS",3.2016,"G"
660,520,1180,"FINE ARTS",2.3333,"G"
570,600,1170,"LIBERAL ARTS",3.4701,"G"
670,680,1350,"NATURAL SCIENCE",3.3,"G"
520,590,1110,"LIBERAL ARTS",3.808,"G"
590,690,1280,"FINE ARTS",3.669,"G"
490,590,1080,"LIBERAL ARTS",2.6754,"G"
620,660,1280,"LIBERAL ARTS",3.1428,"G"
730,640,1370,"NATURAL SCIENCE",2.7933,"G"
520,480,1000,"LIBERAL ARTS",2.5736,"G"
690,620,1310,"NATURAL SCIENCE",3.2802,"G"
480,560,1040,"LIBERAL ARTS",2.5692,"G"
700,500,1200,"COMMUNICATIONS",2.3846,"G"
710,540,1250,"LIBERAL ARTS",3.673,"G"
540,620,1160,"LIBERAL ARTS",2.633,"G"
480,630,1110,"FINE ARTS",3.6126,"G"
500,670,1170,"LIBERAL ARTS",3.6111,"G"
660,710,1370,"BUSINESS",3.1607,"G"
580,580,1160,"FINE ARTS",2.3145,"G"
650,580,1230,"LIBERAL ARTS",3.238,"G"
590,580,1170,"BUSINESS",2.8333,"G"
510,630,1140,"NATURAL SCIENCE",2.2426,"G"
600,540,1140,"LIBERAL ARTS",2.3166,"G"
750,720,1470,"BUSINESS",3.6015,"G"
540,650,1190,"ENGINEERING",3.6971,"G"
730,750,1480,"LIBERAL ARTS",3.8705,"G"
500,550,1050,"BUSINESS",2.8888,"G"
530,590,1120,"BUSINESS",3.2142,"G"
560,590,1150,"NATURAL SCIENCE",3.3962,"G"
580,690,1270,"LIBERAL ARTS",2.57,"G"
500,620,1120,"EDUCATION",2.6822,"G"
590,610,1200,"NATURAL SCIENCE",3.1452,"G"
570,560,1130,"COMMUNICATIONS",2.631,"G"
530,600,1130,"LIBERAL ARTS",3.6111,"G"
530,580,1110,"BUSINESS",2.6574,"G"
800,760,1560,"LIBERAL ARTS",3.8372,"G"
560,560,1120,"BUSINESS",2.5545,"G"
530,640,1170,"LIBERAL ARTS",3.2978,"G"
540,690,1230,"BUSINESS",3.419,"G"
730,600,1330,"LIBERAL ARTS",3.8474,"G"
630,590,1220,"LIBERAL ARTS",2.6814,"G"
500,590,1090,"NATURAL SCIENCE",2.3812,"G"
560,640,1200,"LIBERAL ARTS",2.2543,"G"
700,650,1350,"LIBERAL ARTS",3.3333,"G"
710,690,1400,"NATURAL SCIENCE",2.2844,"G"
520,620,1140,"NATURAL SCIENCE",2.4732,"G"
610,600,1210,"NATURAL SCIENCE",2.8039,"G"
640,710,1350,"BUSINESS",3.6581,"G"
600,520,1120,"LIBERAL ARTS",2.2461,"G"
560,610,1170,"LIBERAL ARTS",3.5137,"G"
570,600,1170,"NATURAL SCIENCE",3.5444,"G"
560,590,1150,"NATURAL SCIENCE",3.3565,"G"
620,690,1310,"ENGINEERING",3.7407,"G"
510,550,1060,"FINE ARTS",3.8226,"G"
650,600,1250,"LIBERAL ARTS",3.3877,"G"
660,690,1350,"LIBERAL ARTS",3.2521,"G"
750,620,1370,"NATURAL SCIENCE",2.0084,"G"
600,600,1200,"LIBERAL ARTS",2.0283,"G"
620,670,1290,"NATURAL SCIENCE",2.9072,"G"
580,630,1210,"LIBERAL ARTS",3.1283,"G"
640,640,1280,"LIBERAL ARTS",3.2772,"G"
600,620,1220,"NATURAL SCIENCE",2.272,"G"
790,790,1580,"ENGINEERING",3.6081,"G"
530,620,1150,"LIBERAL ARTS",3.0322,"G"
480,680,1160,"LIBERAL ARTS",3.0412,"G"
670,660,1330,"LIBERAL ARTS",3.2019,"G"
510,510,1020,"LIBERAL ARTS",2.6928,"G"
700,660,1360,"ENGINEERING",3.7972,"G"
710,770,1480,"LIBERAL ARTS",3.9285,"G"
730,710,1440,"LIBERAL ARTS",3.8041,"G"
640,530,1170,"LIBERAL ARTS",3.9444,"G"
400,480,880,"LIBERAL ARTS",2.4244,"G"
520,470,990,"LIBERAL ARTS",2.7044,"G"
510,440,950,"LIBERAL ARTS",2.7321,"G"
610,650,1260,"LIBERAL ARTS",3.8,"G"
420,390,810,"LIBERAL ARTS",2.3305,"G"
620,650,1270,"LIBERAL ARTS",2.5109,"G"
480,460,940,"LIBERAL ARTS",2.4055,"G"
600,560,1160,"LIBERAL ARTS",3.8018,"G"
620,660,1280,"NATURAL SCIENCE",3.5108,"G"
620,630,1250,"LIBERAL ARTS",3.7923,"G"
520,620,1140,"LIBERAL ARTS",2.6481,"G"
580,700,1280,"COMMUNICATIONS",2.9902,"G"
440,550,990,"ENGINEERING",2.923,"G"
760,740,1500,"LIBERAL ARTS",3.3795,"G"
720,660,1380,"NATURAL SCIENCE",3.3898,"G"
630,610,1240,"LIBERAL ARTS",3.2934,"G"
590,630,1220,"LIBERAL ARTS",3.4534,"G"
480,630,1110,"LIBERAL ARTS",3.576,"G"
440,530,970,"NATURAL SCIENCE",3.5073,"G"
410,390,800,"NATURAL SCIENCE",2.4444,"G"
680,670,1350,"FINE ARTS",2.7379,"G"
480,710,1190,"NATURAL SCIENCE",2.6842,"G"
540,700,1240,"NATURAL SCIENCE",3.088,"G"
430,420,850,"LIBERAL ARTS",2.7769,"G"
630,670,1300,"LIBERAL ARTS",2.6744,"G"
620,630,1250,"ENGINEERING",2.7549,"G"
760,720,1480,"NATURAL SCIENCE",3.9687,"G"
630,540,1170,"LIBERAL ARTS",3.1696,"G"
690,710,1400,"ENGINEERING",3.226,"G"
630,630,1260,"NATURAL SCIENCE",2.8353,"G"
420,430,850,"BUSINESS",2.6363,"G"
660,660,1320,"NATURAL SCIENCE",2.6642,"G"
510,510,1020,"BUSINESS",2.584,"G"
610,630,1240,"LIBERAL ARTS",3.0729,"G"
580,660,1240,"LIBERAL ARTS",3.3333,"G"
550,650,1200,"ENGINEERING",2.6803,"G"
560,550,1110,"LIBERAL ARTS",2.4552,"G"
610,720,1330,"LIBERAL ARTS",2.6228,"G"
630,660,1290,"LIBERAL ARTS",3.2075,"G"
630,670,1300,"ENGINEERING",2.6488,"G"
560,640,1200,"LIBERAL ARTS",2.7666,"G"
480,700,1180,"NURSING",3.8035,"G"
530,680,1210,"BUSINESS",3.826,"G"
520,660,1180,"NATURAL SCIENCE",3.1165,"G"
630,610,1240,"ENGINEERING",3.6393,"G"
530,620,1150,"NATURAL SCIENCE",3.3627,"G"
740,650,1390,"LIBERAL ARTS",3.6168,"G"
650,570,1220,"LIBERAL ARTS",2.2682,"G"
530,590,1120,"NATURAL SCIENCE",2.546,"G"
620,610,1230,"LIBERAL ARTS",2.7592,"G"
440,670,1110,"ENGINEERING",2.8016,"G"
530,580,1110,"BUSINESS",3.4418,"G"
660,650,1310,"LIBERAL ARTS",2.3862,"G"
500,610,1110,"LIBERAL ARTS",3.5048,"G"
590,610,1200,"LIBERAL ARTS",3.7375,"G"
570,690,1260,"NATURAL SCIENCE",3.6826,"G"
610,550,1160,"LIBERAL ARTS",3.2366,"G"
580,580,1160,"BUSINESS",3.2173,"G"
500,550,1050,"EDUCATION",3.8455,"G"
650,600,1250,"COMMUNICATIONS",2.8492,"G"
470,590,1060,"BUSINESS",3.344,"G"
580,730,1310,"BUSINESS",3.9732,"G"
530,510,1040,"LIBERAL ARTS",3.2605,"G"
530,610,1140,"BUSINESS",3.0693,"G"
690,570,1260,"LIBERAL ARTS",3.6115,"G"
390,500,890,"BUSINESS",2.7115,"G"
700,680,1380,"ENGINEERING",3.2695,"G"
410,490,900,"BUSINESS",2.9075,"G"
520,620,1140,"LIBERAL ARTS",3.7786,"G"
550,670,1220,"LIBERAL ARTS",2.0079,"G"
690,700,1390,"NATURAL SCIENCE",3.4822,"G"
470,470,940,"LIBERAL ARTS",3.3584,"G"
540,680,1220,"LIBERAL ARTS",2.5185,"G"
480,560,1040,"LIBERAL ARTS",3.8543,"G"
590,630,1220,"LIBERAL ARTS",3.2702,"G"
600,580,1180,"NATURAL SCIENCE",3.5035,"G"
760,710,1470,"LIBERAL ARTS",3.9795,"G"
650,610,1260,"NATURAL SCIENCE",3.438,"G"
610,590,1200,"LIBERAL ARTS",3.215,"G"
600,610,1210,"NATURAL SCIENCE",3.0777,"G"
710,640,1350,"BUSINESS",3.303,"G"
660,600,1260,"LIBERAL ARTS",3.1428,"G"
680,670,1350,"NATURAL SCIENCE",4,"G"
630,740,1370,"ENGINEERING",3.225,"G"
560,690,1250,"ENGINEERING",3.2394,"G"
500,600,1100,"NATURAL SCIENCE",2.5437,"G"
670,800,1470,"ENGINEERING",4,"G"
700,700,1400,"LIBERAL ARTS",3.5923,"G"
560,660,1220,"NATURAL SCIENCE",2.5912,"G"
530,680,1210,"NATURAL SCIENCE",2.4122,"G"
500,690,1190,"BUSINESS",3.0277,"G"
660,630,1290,"BUSINESS",2.8969,"G"
590,510,1100,"NATURAL SCIENCE",3.4062,"G"
460,460,920,"FINE ARTS",3.1078,"G"
730,790,1520,"LIBERAL ARTS",3.9774,"G"
690,650,1340,"LIBERAL ARTS",2.5479,"G"
570,770,1340,"BUSINESS",3.8,"G"
630,590,1220,"NATURAL SCIENCE",2.788,"G"
520,550,1070,"LIBERAL ARTS",3.9117,"G"
540,640,1180,"NURSING",3.2131,"G"
630,650,1280,"ENGINEERING",3.3043,"G"
510,710,1220,"ENGINEERING",3.7345,"G"
670,690,1360,"FINE ARTS",3.8863,"G"
600,680,1280,"BUSINESS",3.8762,"G"
630,640,1270,"LIBERAL ARTS",3.2727,"G"
610,510,1120,"NATURAL SCIENCE",2.4812,"G"
490,480,970,"EDUCATION",2.089,"G"
660,620,1280,"ENGINEERING",2.8508,"G"
590,630,1220,"LIBERAL ARTS",3.3937,"G"
630,580,1210,"EDUCATION",3.7216,"G"
550,490,1040,"LIBERAL ARTS",3.5471,"G"
570,600,1170,"COMMUNICATIONS",3.3644,"G"
420,490,910,"LIBERAL ARTS",2.7874,"G"
560,530,1090,"LIBERAL ARTS",3.0769,"G"
700,630,1330,"LIBERAL ARTS",2.9259,"G"
750,690,1440,"NATURAL SCIENCE",3.653,"G"
720,760,1480,"LIBERAL ARTS",3.6115,"G"
680,670,1350,"NATURAL SCIENCE",3.4882,"G"
660,640,1300,"LIBERAL ARTS",2.2936,"G"
480,570,1050,"LIBERAL ARTS",3.0979,"G"
520,520,1040,"NATURAL SCIENCE",3.5984,"G"
620,700,1320,"LIBERAL ARTS",3.8548,"G"
520,470,990,"LIBERAL ARTS",2.264,"G"
700,510,1210,"LIBERAL ARTS",3.46,"G"
540,520,1060,"NATURAL SCIENCE",3.5321,"G"
590,800,1390,"ENGINEERING",3.8604,"G"
580,570,1150,"LIBERAL ARTS",3.9734,"G"
600,760,1360,"BUSINESS",3.3333,"G"
540,580,1120,"ENGINEERING",2.6304,"G"
710,660,1370,"BUSINESS",3.7358,"G"
510,610,1120,"NATURAL SCIENCE",4,"G"
630,540,1170,"FINE ARTS",2.7786,"G"
560,610,1170,"NATURAL SCIENCE",2.5128,"G"
690,660,1350,"ENGINEERING",3.1623,"G"
560,540,1100,"NATURAL SCIENCE",3.0232,"G"
580,540,1120,"COMMUNICATIONS",3.85,"G"
660,630,1290,"COMMUNICATIONS",3.6386,"G"
470,550,1020,"LIBERAL ARTS",2.3684,"G"
600,650,1250,"ARCHITECTURE",2.8514,"G"
700,600,1300,"BUSINESS",3.8137,"G"
700,690,1390,"BUSINESS",3.192,"G"
490,530,1020,"ENGINEERING",2.7016,"G"
590,640,1230,"LIBERAL ARTS",3.3944,"G"
470,430,900,"COMMUNICATIONS",3.1477,"G"
610,610,1220,"LIBERAL ARTS",2.319,"G"
510,620,1130,"FINE ARTS",3.7372,"G"
700,740,1440,"ENGINEERING",3.2781,"G"
460,380,840,"BUSINESS",2.6896,"G"
500,480,980,"LIBERAL ARTS",3.1603,"G"
720,760,1480,"ARCHITECTURE",3.6623,"G"
680,680,1360,"LIBERAL ARTS",3.4631,"G"
480,570,1050,"LIBERAL ARTS",2.8974,"G"
530,590,1120,"LIBERAL ARTS",2.5639,"G"
560,640,1200,"BUSINESS",2.7524,"G"
620,590,1210,"FINE ARTS",3.6129,"G"
600,520,1120,"EDUCATION",2.2952,"G"
710,670,1380,"LIBERAL ARTS",3.8762,"G"
660,660,1320,"COMMUNICATIONS",3.1875,"G"
510,550,1060,"BUSINESS",2.8037,"G"
580,650,1230,"ENGINEERING",3.155,"G"
690,680,1370,"ENGINEERING",3.3333,"G"
480,470,950,"LIBERAL ARTS",2.7443,"G"
690,650,1340,"FINE ARTS",2.6258,"G"
600,710,1310,"BUSINESS",3.6082,"G"
540,560,1100,"LIBERAL ARTS",2.9255,"G"
680,680,1360,"NATURAL SCIENCE",4,"G"
690,800,1490,"BUSINESS",2.6754,"G"
710,730,1440,"ENGINEERING",3.6641,"G"
600,560,1160,"LIBERAL ARTS",3.093,"G"
630,570,1200,"LIBERAL ARTS",3.1481,"G"
620,610,1230,"LIBERAL ARTS",2.6713,"G"
570,540,1110,"LIBERAL ARTS",2.5263,"G"
680,720,1400,"ENGINEERING",2.6384,"G"
530,580,1110,"LIBERAL ARTS",2.5253,"G"
710,690,1400,"BUSINESS",3.9166,"G"
690,720,1410,"COMMUNICATIONS",3.3739,"G"
530,720,1250,"ENGINEERING",3.2368,"G"
670,590,1260,"LIBERAL ARTS",3.7669,"G"
660,520,1180,"LIBERAL ARTS",2.2653,"G"
550,590,1140,"NATURAL SCIENCE",3.5765,"G"
670,630,1300,"LIBERAL ARTS",2.6721,"G"
640,700,1340,"NATURAL SCIENCE",3.5471,"G"
600,560,1160,"BUSINESS",2.7415,"G"
480,510,990,"BUSINESS",3.5785,"G"
670,630,1300,"ENGINEERING",2.4645,"G"
580,490,1070,"LIBERAL ARTS",3.125,"G"
800,800,1600,"LIBERAL ARTS",3.9358,"G"
640,650,1290,"BUSINESS",3.7169,"G"
570,580,1150,"LIBERAL ARTS",3.2941,"G"
490,590,1080,"NATURAL SCIENCE",2.8545,"G"
600,630,1230,"NATURAL SCIENCE",2.9652,"G"
700,800,1500,"BUSINESS",3.9784,"G"
570,490,1060,"EDUCATION",3.0434,"G"
440,420,860,"EDUCATION",3.4793,"G"
610,600,1210,"NATURAL SCIENCE",2.9509,"G"
750,750,1500,"BUSINESS",3.8807,"G"
600,600,1200,"FINE ARTS",3.3773,"G"
620,790,1410,"NATURAL SCIENCE",3.9248,"G"
580,660,1240,"ENGINEERING",3.3442,"G"
630,580,1210,"NATURAL SCIENCE",2.5476,"G"
540,560,1100,"NATURAL SCIENCE",3.3908,"G"
630,710,1340,"LIBERAL ARTS",3.3225,"G"
490,600,1090,"LIBERAL ARTS",2.6636,"G"
550,550,1100,"NATURAL SCIENCE",3.0813,"G"
620,610,1230,"COMMUNICATIONS",3.617,"G"
790,600,1390,"ENGINEERING",2.8992,"G"
630,660,1290,"FINE ARTS",3.5142,"G"
550,500,1050,"BUSINESS",3.387,"G"
520,680,1200,"NATURAL SCIENCE",3.0827,"G"
570,550,1120,"BUSINESS",2.5,"G"
600,610,1210,"NATURAL SCIENCE",2.0317,"G"
630,670,1300,"ENGINEERING",3.6461,"G"
730,730,1460,"LIBERAL ARTS",3.9727,"G"
630,640,1270,"LIBERAL ARTS",3.155,"G"
640,620,1260,"BUSINESS",2.258,"G"
580,630,1210,"ENGINEERING",3.307,"G"
620,560,1180,"NATURAL SCIENCE",3.2148,"G"
710,710,1420,"LIBERAL ARTS",2.2857,"G"
620,700,1320,"NATURAL SCIENCE",2.0327,"G"
660,680,1340,"LIBERAL ARTS",3.8369,"G"
590,600,1190,"LIBERAL ARTS",2.9117,"G"
650,640,1290,"LIBERAL ARTS",2.5966,"G"
560,520,1080,"BUSINESS",2.64,"G"
390,480,870,"LIBERAL ARTS",3.0824,"G"
630,800,1430,"BUSINESS",3.7352,"G"
510,700,1210,"BUSINESS",3.1428,"G"
570,530,1100,"COMMUNICATIONS",2.734,"G"
490,490,980,"LIBERAL ARTS",2.4964,"G"
550,600,1150,"BUSINESS",3.0404,"G"
570,680,1250,"ENGINEERING",2.3412,"G"
800,610,1410,"LIBERAL ARTS",3.1588,"G"
620,710,1330,"ARCHITECTURE",3.4771,"G"
680,640,1320,"LIBERAL ARTS",3.5098,"G"
570,720,1290,"ENGINEERING",3.11,"G"
520,680,1200,"LIBERAL ARTS",3.2376,"G"
570,700,1270,"ENGINEERING",2.8695,"G"
560,570,1130,"NATURAL SCIENCE",2.726,"G"
660,690,1350,"LIBERAL ARTS",3.2346,"G"
480,520,1000,"NATURAL SCIENCE",2.8275,"G"
480,500,980,"BUSINESS",3.4444,"G"
800,690,1490,"ENGINEERING",3.653,"G"
590,660,1250,"NURSING",3.307,"G"
580,600,1180,"NATURAL SCIENCE",3.1631,"G"
530,650,1180,"LIBERAL ARTS",3.02,"G"
410,530,940,"BUSINESS",2.5508,"G"
560,610,1170,"LIBERAL ARTS",2.7619,"G"
770,760,1530,"ENGINEERING",3.3956,"G"
450,450,900,"BUSINESS",2.5327,"G"
510,590,1100,"NURSING",3.1864,"G"
600,640,1240,"NATURAL SCIENCE",3.1862,"G"
540,610,1150,"NATURAL SCIENCE",3.5981,"G"
490,530,1020,"BUSINESS",3.3402,"G"
380,530,910,"NATURAL SCIENCE",2.6528,"G"
580,630,1210,"LIBERAL ARTS",3.4956,"G"
570,590,1160,"LIBERAL ARTS",3.0631,"G"
510,550,1060,"ENGINEERING",2.1304,"G"
680,740,1420,"NATURAL SCIENCE",3.3195,"G"
580,570,1150,"LIBERAL ARTS",3.9508,"G"
520,520,1040,"FINE ARTS",3.3902,"G"
590,550,1140,"LIBERAL ARTS",3.3203,"G"
600,730,1330,"LIBERAL ARTS",3.7961,"G"
650,700,1350,"NATURAL SCIENCE",2.0975,"G"
600,610,1210,"COMMUNICATIONS",3.1844,"G"
530,480,1010,"EDUCATION",3.0719,"G"
610,580,1190,"NATURAL SCIENCE",2.3464,"G"
470,580,1050,"ENGINEERING",3.7338,"G"
580,690,1270,"BUSINESS",3.8404,"G"
540,600,1140,"BUSINESS",3.268,"G"
730,550,1280,"LIBERAL ARTS",3.4609,"G"
600,600,1200,"NATURAL SCIENCE",3.6842,"G"
620,690,1310,"NATURAL SCIENCE",2.937,"G"
580,680,1260,"COMMUNICATIONS",3.7029,"G"
530,520,1050,"NATURAL SCIENCE",3.2826,"G"
710,540,1250,"NATURAL SCIENCE",3.1487,"G"
570,700,1270,"NATURAL SCIENCE",3.324,"G"
500,490,990,"LIBERAL ARTS",2.65,"G"
570,700,1270,"NATURAL SCIENCE",3.647,"G"
560,650,1210,"NATURAL SCIENCE",3.1709,"G"
650,590,1240,"LIBERAL ARTS",3.8314,"G"
600,660,1260,"LIBERAL ARTS",3.3333,"G"
550,550,1100,"NATURAL SCIENCE",2.9515,"G"
610,500,1110,"ENGINEERING",2.6969,"G"
500,600,1100,"LIBERAL ARTS",2.4482,"G"
730,700,1430,"LIBERAL ARTS",3.809,"G"
570,590,1160,"COMMUNICATIONS",2.7227,"G"
760,800,1560,"LIBERAL ARTS",3.982,"G"
600,660,1260,"COMMUNICATIONS",3.7656,"G"
530,580,1110,"EDUCATION",3.4803,"G"
700,570,1270,"NATURAL SCIENCE",2.448,"G"
650,650,1300,"BUSINESS",3.6868,"G"
540,590,1130,"NATURAL SCIENCE",3.2809,"G"
670,790,1460,"NATURAL SCIENCE",3.8029,"G"
720,650,1370,"NATURAL SCIENCE",3.8521,"G"
520,500,1020,"LIBERAL ARTS",2.4814,"G"
610,530,1140,"LIBERAL ARTS",2.6272,"G"
570,580,1150,"NATURAL SCIENCE",3.3615,"G"
530,600,1130,"LIBERAL ARTS",3.6129,"G"
610,570,1180,"COMMUNICATIONS",2.8426,"G"
640,610,1250,"BUSINESS",3.6,"G"
570,640,1210,"ENGINEERING",2.2733,"G"
570,540,1110,"ENGINEERING",3.438,"G"
640,580,1220,"BUSINESS",2.9166,"G"
440,460,900,"LIBERAL ARTS",2.6299,"G"
590,660,1250,"EDUCATION",2.8661,"G"
690,610,1300,"BUSINESS",3.5217,"G"
720,620,1340,"LIBERAL ARTS",3.7938,"G"
530,630,1160,"NATURAL SCIENCE",2.7744,"G"
650,700,1350,"ENGINEERING",3.7536,"G"
560,640,1200,"LIBERAL ARTS",2.1162,"G"
650,640,1290,"LIBERAL ARTS",2.5905,"G"
610,680,1290,"LIBERAL ARTS",3.8144,"G"
560,660,1220,"ENGINEERING",3.6511,"G"
570,550,1120,"COMMUNICATIONS",3.7021,"G"
760,650,1410,"LIBERAL ARTS",3.822,"G"
640,490,1130,"BUSINESS",3.0204,"G"
500,640,1140,"NATURAL SCIENCE",3.472,"G"
610,790,1400,"NATURAL SCIENCE",3.939,"G"
450,570,1020,"ENGINEERING",2.82,"G"
550,500,1050,"NATURAL SCIENCE",3.6851,"G"
580,490,1070,"LIBERAL ARTS",2.8582,"G"
580,550,1130,"NATURAL SCIENCE",2.9652,"G"
650,650,1300,"NATURAL SCIENCE",2.3027,"G"
580,680,1260,"ENGINEERING",3.6106,"G"
590,550,1140,"LIBERAL ARTS",2.9217,"G"
560,630,1190,"NATURAL SCIENCE",3.4859,"G"
580,500,1080,"NATURAL SCIENCE",2.4223,"G"
570,630,1200,"BUSINESS",3.1276,"G"
640,650,1290,"FINE ARTS",3.6826,"G"
650,800,1450,"ENGINEERING",3.3059,"G"
610,620,1230,"NATURAL SCIENCE",2.8582,"G"
580,580,1160,"NATURAL SCIENCE",3.048,"G"
530,700,1230,"LIBERAL ARTS",2.8316,"G"
640,500,1140,"FINE ARTS",3.1851,"G"
620,680,1300,"BUSINESS",2.4594,"G"
670,710,1380,"BUSINESS",3.9622,"G"
560,540,1100,"NATURAL SCIENCE",3.0168,"G"
580,510,1090,"EDUCATION",3.5922,"G"
590,630,1220,"ENGINEERING",3.469,"G"
510,490,1000,"BUSINESS",2.594,"G"
720,700,1420,"LIBERAL ARTS",3.848,"G"
580,640,1220,"LIBERAL ARTS",3.6637,"G"
590,690,1280,"NATURAL SCIENCE",3.5462,"G"
750,790,1540,"LIBERAL ARTS",2.7071,"G"
470,540,1010,"LIBERAL ARTS",3.0162,"G"
560,700,1260,"LIBERAL ARTS",2.5973,"G"
520,610,1130,"LIBERAL ARTS",2.4418,"G"
590,610,1200,"BUSINESS",3.3958,"G"
630,620,1250,"LIBERAL ARTS",3.8085,"G"
570,560,1130,"LIBERAL ARTS",3.6,"G"
470,680,1150,"NATURAL SCIENCE",2.9357,"G"
750,740,1490,"BUSINESS",3.8301,"G"
470,480,950,"NATURAL SCIENCE",2.7114,"G"
620,530,1150,"LIBERAL ARTS",3.2288,"G"
620,660,1280,"FINE ARTS",3.2272,"G"
600,530,1130,"NATURAL SCIENCE",3.5862,"G"
560,480,1040,"LIBERAL ARTS",3.2869,"G"
700,710,1410,"NATURAL SCIENCE",3.5225,"G"
610,540,1150,"LIBERAL ARTS",3.019,"G"
600,520,1120,"LIBERAL ARTS",2.9181,"G"
560,520,1080,"EDUCATION",3.8421,"G"
580,490,1070,"COMMUNICATIONS",3.1592,"G"
700,800,1500,"NATURAL SCIENCE",2.7327,"G"
580,600,1180,"BUSINESS",2.8545,"G"
460,540,1000,"LIBERAL ARTS",3.3333,"G"
630,770,1400,"BUSINESS",3.8059,"G"
530,680,1210,"ENGINEERING",2.2328,"G"
570,620,1190,"NATURAL SCIENCE",3.0833,"G"
550,640,1190,"NATURAL SCIENCE",3.3398,"G"
560,700,1260,"NATURAL SCIENCE",3.8476,"G"
500,610,1110,"NATURAL SCIENCE",3.1048,"G"
670,610,1280,"LIBERAL ARTS",3.9343,"G"
430,730,1160,"ENGINEERING",2.872,"G"
580,650,1230,"BUSINESS",3.8709,"G"
590,570,1160,"NATURAL SCIENCE",3.5547,"G"
550,660,1210,"BUSINESS",3.7166,"G"
690,800,1490,"ENGINEERING",3.8741,"G"
640,480,1120,"EDUCATION",2.844,"G"
560,580,1140,"NATURAL SCIENCE",3.6372,"G"
520,620,1140,"LIBERAL ARTS",3.413,"G"
540,590,1130,"BUSINESS",2.9716,"G"
540,660,1200,"NATURAL SCIENCE",3.2524,"G"
680,530,1210,"EDUCATION",3.0098,"G"
620,540,1160,"LIBERAL ARTS",3.3482,"G"
620,740,1360,"BUSINESS",3.659,"G"
700,620,1320,"ENGINEERING",3.3125,"G"
600,680,1280,"ENGINEERING",3.2,"G"
530,570,1100,"LIBERAL ARTS",2.7931,"G"
500,570,1070,"FINE ARTS",3.1287,"G"
590,700,1290,"COMMUNICATIONS",3.2187,"G"
620,650,1270,"LIBERAL ARTS",3.5673,"G"
550,680,1230,"BUSINESS",3.238,"G"
560,570,1130,"LIBERAL ARTS",3.9302,"G"
630,610,1240,"BUSINESS",3.1714,"G"
570,540,1110,"BUSINESS",3.1782,"G"
640,760,1400,"LIBERAL ARTS",3.8739,"G"
570,550,1120,"EDUCATION",3.4242,"G"
630,720,1350,"ENGINEERING",3.4532,"G"
570,690,1260,"ENGINEERING",3.2452,"G"
690,670,1360,"BUSINESS",3.8692,"G"
550,490,1040,"LIBERAL ARTS",3.2894,"G"
550,580,1130,"NATURAL SCIENCE",3.0808,"G"
650,570,1220,"BUSINESS",3.2868,"G"
590,670,1260,"NATURAL SCIENCE",3.2413,"G"
560,720,1280,"BUSINESS",2.8303,"G"
560,700,1260,"ENGINEERING",3.2523,"G"
540,650,1190,"LIBERAL ARTS",3.5538,"G"
740,590,1330,"LIBERAL ARTS",2.6614,"G"
510,670,1180,"LIBERAL ARTS",2.2016,"G"
560,610,1170,"LIBERAL ARTS",2.3357,"G"
580,660,1240,"ENGINEERING",3.3649,"G"
510,630,1140,"BUSINESS",3.6442,"G"
610,660,1270,"LIBERAL ARTS",3.3645,"G"
800,770,1570,"ENGINEERING",4,"G"
520,620,1140,"LIBERAL ARTS",3.0099,"G"
610,620,1230,"ENGINEERING",3.3394,"G"
580,560,1140,"NATURAL SCIENCE",3.6526,"G"
530,700,1230,"ENGINEERING",3.0087,"G"
510,600,1110,"NATURAL SCIENCE",3.2352,"G"
600,690,1290,"BUSINESS",3.4011,"G"
570,520,1090,"LIBERAL ARTS",2.4392,"G"
700,580,1280,"LIBERAL ARTS",3.3267,"G"
580,630,1210,"BUSINESS",3.6336,"G"
570,710,1280,"NATURAL SCIENCE",2.9837,"G"
670,520,1190,"NATURAL SCIENCE",2.3629,"G"
610,620,1230,"NATURAL SCIENCE",2.9361,"G"
540,590,1130,"COMMUNICATIONS",2.6465,"G"
760,680,1440,"ARCHITECTURE",3.619,"G"
600,590,1190,"LIBERAL ARTS",3.0505,"G"
660,680,1340,"ENGINEERING",2.5933,"G"
620,560,1180,"LIBERAL ARTS",3.504,"G"
610,650,1260,"BUSINESS",3.6,"G"
470,630,1100,"EDUCATION",3.3203,"G"
710,670,1380,"LIBERAL ARTS",3.4883,"G"
630,600,1230,"LIBERAL ARTS",3.2197,"G"
640,570,1210,"LIBERAL ARTS",3.1467,"G"
700,790,1490,"BUSINESS",3.445,"G"
540,560,1100,"FINE ARTS",2.9821,"G"
510,490,1000,"LIBERAL ARTS",3.3027,"G"
500,540,1040,"LIBERAL ARTS",3.0833,"G"
670,630,1300,"NATURAL SCIENCE",2.802,"G"
760,790,1550,"ENGINEERING",3.6744,"G"
630,690,1320,"ENGINEERING",2.6209,"G"
610,590,1200,"ENGINEERING",2.9701,"G"
540,470,1010,"LIBERAL ARTS",3.0877,"G"
720,790,1510,"NATURAL SCIENCE",3.3972,"G"
570,670,1240,"LIBERAL ARTS",2.5163,"G"
630,700,1330,"ENGINEERING",3.2713,"G"
550,540,1090,"LIBERAL ARTS",3.048,"G"
550,540,1090,"EDUCATION",3.344,"G"
730,590,1320,"LIBERAL ARTS",3.2743,"G"
680,630,1310,"LIBERAL ARTS",3.0956,"G"
560,700,1260,"LIBERAL ARTS",3.6259,"G"
620,620,1240,"NATURAL SCIENCE",2.88,"G"
470,690,1160,"LIBERAL ARTS",2.6319,"G"
630,610,1240,"BUSINESS",3.2079,"G"
610,590,1200,"NATURAL SCIENCE",3.032,"G"
430,470,900,"BUSINESS",2.4666,"G"
620,730,1350,"ENGINEERING",2.691,"G"
640,650,1290,"NATURAL SCIENCE",3.6486,"G"
540,600,1140,"FINE ARTS",3.0884,"G"
650,670,1320,"NATURAL SCIENCE",3.5963,"G"
540,640,1180,"ENGINEERING",3.0275,"G"
580,540,1120,"NATURAL SCIENCE",3.2777,"G"
520,670,1190,"BUSINESS",3.4818,"G"
710,620,1330,"LIBERAL ARTS",3.2293,"G"
520,580,1100,"BUSINESS",3.25,"G"
500,740,1240,"ENGINEERING",3.3307,"G"
530,480,1010,"LIBERAL ARTS",2.5547,"G"
670,590,1260,"LIBERAL ARTS",2.4202,"G"
710,700,1410,"NATURAL SCIENCE",3.2812,"G"
630,680,1310,"BUSINESS",3.3913,"G"
610,650,1260,"NATURAL SCIENCE",3.2056,"G"
690,640,1330,"LIBERAL ARTS",3.5039,"G"
580,720,1300,"NATURAL SCIENCE",3.0792,"G"
750,670,1420,"BUSINESS",3.4141,"G"
530,520,1050,"NATURAL SCIENCE",2.6492,"G"
630,560,1190,"COMMUNICATIONS",3.5952,"G"
550,600,1150,"LIBERAL ARTS",2.5714,"G"
620,630,1250,"LIBERAL ARTS",3.76,"G"
700,730,1430,"BUSINESS",2.448,"G"
710,740,1450,"NATURAL SCIENCE",3.9732,"G"
720,650,1370,"LIBERAL ARTS",3.2611,"G"
610,660,1270,"LIBERAL ARTS",3.2307,"G"
550,670,1220,"ENGINEERING",2.7169,"G"
640,520,1160,"FINE ARTS",3.1623,"G"
650,650,1300,"LIBERAL ARTS",3.2661,"G"
530,580,1110,"NATURAL SCIENCE",3.6301,"G"
510,530,1040,"BUSINESS",3.1629,"G"
600,730,1330,"NATURAL SCIENCE",3.0428,"G"
470,440,910,"NATURAL SCIENCE",2.6369,"G"
540,680,1220,"NATURAL SCIENCE",2.6086,"G"
450,500,950,"NURSING",2.437,"G"
470,460,930,"LIBERAL ARTS",3.2352,"G"
570,650,1220,"ENGINEERING",2.8613,"G"
630,590,1220,"NATURAL SCIENCE",3.3076,"G"
640,720,1360,"ENGINEERING",2.7898,"G"
670,720,1390,"ENGINEERING",3.5648,"G"
580,700,1280,"BUSINESS",3.3846,"G"
580,600,1180,"EDUCATION",2.7967,"G"
650,610,1260,"NATURAL SCIENCE",3.1481,"G"
630,670,1300,"ENGINEERING",2.5815,"G"
640,680,1320,"LIBERAL ARTS",3.6981,"G"
550,660,1210,"ENGINEERING",2.606,"G"
710,630,1340,"LIBERAL ARTS",3.7766,"G"
650,650,1300,"NATURAL SCIENCE",3.4519,"G"
530,650,1180,"BUSINESS",3.103,"G"
470,470,940,"LIBERAL ARTS",2.9818,"G"
680,640,1320,"LIBERAL ARTS",2.485,"G"
630,600,1230,"LIBERAL ARTS",3.0673,"G"
710,610,1320,"LIBERAL ARTS",2.9896,"G"
440,570,1010,"LIBERAL ARTS",2.8235,"G"
430,420,850,"BUSINESS",2.5892,"G"
580,650,1230,"NATURAL SCIENCE",3.1327,"G"
620,560,1180,"LIBERAL ARTS",3.8421,"G"
640,650,1290,"ARCHITECTURE",3.7651,"G"
730,690,1420,"ENGINEERING",3.8114,"G"
540,480,1020,"BUSINESS",2.9222,"G"
560,520,1080,"COMMUNICATIONS",3.34,"G"
580,590,1170,"LIBERAL ARTS",3.3188,"G"
550,730,1280,"ENGINEERING",2.5374,"G"
530,540,1070,"NATURAL SCIENCE",2.384,"G"
500,590,1090,"ENGINEERING",3.0508,"G"
630,620,1250,"LIBERAL ARTS",2.1428,"G"
480,530,1010,"BUSINESS",3.376,"G"
610,620,1230,"NATURAL SCIENCE",3.647,"G"
570,540,1110,"EDUCATION",3.2211,"G"
480,510,990,"LIBERAL ARTS",1.9767,"G"
530,660,1190,"BUSINESS",3.6226,"G"
580,580,1160,"NATURAL SCIENCE",2.3561,"G"
580,560,1140,"NATURAL SCIENCE",2.8333,"G"
750,770,1520,"BUSINESS",3.6291,"G"
530,630,1160,"LIBERAL ARTS",2.7,"G"
640,590,1230,"LIBERAL ARTS",3.0517,"G"
580,570,1150,"COMMUNICATIONS",3.5955,"G"
580,600,1180,"NATURAL SCIENCE",3.0961,"G"
490,570,1060,"BUSINESS",3.0083,"G"
760,500,1260,"LIBERAL ARTS",2.9586,"G"
530,570,1100,"LIBERAL ARTS",2.8907,"G"
630,700,1330,"NATURAL SCIENCE",3.6439,"G"
720,760,1480,"ENGINEERING",2.4814,"G"
660,650,1310,"LIBERAL ARTS",3.3009,"G"
640,600,1240,"NATURAL SCIENCE",3.7555,"G"
720,690,1410,"NATURAL SCIENCE",3.2095,"G"
530,500,1030,"LIBERAL ARTS",3.8556,"G"
650,680,1330,"BUSINESS",3.9302,"G"
610,530,1140,"LIBERAL ARTS",3.7716,"G"
610,610,1220,"BUSINESS",3.6893,"G"
770,630,1400,"LIBERAL ARTS",3.7857,"G"
700,540,1240,"LIBERAL ARTS",2.9062,"G"
710,640,1350,"NATURAL SCIENCE",3.1007,"G"
760,640,1400,"LIBERAL ARTS",3.4778,"G"
680,650,1330,"NURSING",3.2677,"G"
470,530,1000,"ENGINEERING",2.4026,"G"
600,630,1230,"BUSINESS",3.5473,"G"
590,590,1180,"COMMUNICATIONS",3.7984,"G"
680,670,1350,"BUSINESS",4,"G"
540,680,1220,"LIBERAL ARTS",2.0583,"G"
600,590,1190,"NATURAL SCIENCE",2.4962,"G"
400,420,820,"NATURAL SCIENCE",2.2617,"G"
540,670,1210,"LIBERAL ARTS",2.9326,"G"
760,590,1350,"LIBERAL ARTS",2.5728,"G"
670,670,1340,"ENGINEERING",2.6578,"G"
580,640,1220,"FINE ARTS",3.0378,"G"
680,620,1300,"COMMUNICATIONS",3.862,"G"
590,630,1220,"LIBERAL ARTS",3.3052,"G"
500,580,1080,"LIBERAL ARTS",3.6847,"G"
660,620,1280,"BUSINESS",3.9469,"G"
450,490,940,"BUSINESS",2.4158,"G"
560,620,1180,"LIBERAL ARTS",2.8424,"G"
620,710,1330,"BUSINESS",3.3523,"G"
570,550,1120,"LIBERAL ARTS",3.9677,"G"
510,540,1050,"BUSINESS",2.8253,"G"
530,480,1010,"LIBERAL ARTS",2.4881,"G"
610,540,1150,"NATURAL SCIENCE",3.4134,"G"
510,630,1140,"FINE ARTS",3.3173,"G"
500,640,1140,"ENGINEERING",3.8778,"G"
550,550,1100,"LIBERAL ARTS",2.5,"G"
590,680,1270,"BUSINESS",2.617,"G"
570,540,1110,"COMMUNICATIONS",2.4666,"G"
650,740,1390,"NATURAL SCIENCE",3.9097,"G"
660,600,1260,"COMMUNICATIONS",3.2338,"G"
560,570,1130,"NATURAL SCIENCE",3.1888,"G"
640,610,1250,"LIBERAL ARTS",2.874,"G"
510,530,1040,"LIBERAL ARTS",3.8728,"G"
700,690,1390,"NATURAL SCIENCE",3.7555,"G"
680,740,1420,"BUSINESS",3.5424,"G"
550,670,1220,"BUSINESS",3.1796,"G"
530,590,1120,"LIBERAL ARTS",3.1592,"G"
480,690,1170,"LIBERAL ARTS",3.1326,"G"
540,610,1150,"NATURAL SCIENCE",3.1679,"G"
530,620,1150,"LIBERAL ARTS",2.6949,"G"
580,620,1200,"LIBERAL ARTS",2.6875,"G"
650,590,1240,"LIBERAL ARTS",3.238,"G"
620,710,1330,"BUSINESS",2.6747,"G"
630,470,1100,"COMMUNICATIONS",3.9638,"G"
460,490,950,"EDUCATION",2.9674,"G"
510,510,1020,"LIBERAL ARTS",3.5086,"G"
500,550,1050,"EDUCATION",2.4594,"G"
510,790,1300,"LIBERAL ARTS",3.8684,"G"
590,560,1150,"NATURAL SCIENCE",2.9607,"G"
730,750,1480,"NATURAL SCIENCE",3.8571,"G"
590,680,1270,"BUSINESS",4,"G"
580,570,1150,"LIBERAL ARTS",2.9909,"G"
640,700,1340,"ENGINEERING",3.4736,"G"
600,570,1170,"LIBERAL ARTS",3.5636,"G"
560,650,1210,"NATURAL SCIENCE",3.5074,"G"
480,610,1090,"LIBERAL ARTS",3.0247,"G"
550,640,1190,"ENGINEERING",3.0215,"G"
560,600,1160,"LIBERAL ARTS",3.6315,"G"
640,650,1290,"NURSING",3.097,"G"
560,690,1250,"NATURAL SCIENCE",2.909,"G"
590,480,1070,"ENGINEERING",3.6564,"G"
560,590,1150,"BUSINESS",3.08,"G"
680,770,1450,"NATURAL SCIENCE",3.7115,"G"
600,720,1320,"BUSINESS",3.9439,"G"
660,700,1360,"NATURAL SCIENCE",3.2295,"G"
420,530,950,"LIBERAL ARTS",2.248,"G"
750,710,1460,"BUSINESS",3.6293,"G"
510,650,1160,"LIBERAL ARTS",2.3454,"G"
550,790,1340,"NATURAL SCIENCE",3.8198,"G"
510,480,990,"FINE ARTS",3.625,"G"
530,510,1040,"NATURAL SCIENCE",2.696,"G"
640,640,1280,"NATURAL SCIENCE",3.218,"G"
460,580,1040,"BUSINESS",2.5904,"G"
720,750,1470,"BUSINESS",3.8121,"G"
490,550,1040,"LIBERAL ARTS",2.1328,"G"
510,580,1090,"NATURAL SCIENCE",3.4316,"G"
590,490,1080,"LIBERAL ARTS",3.9062,"G"
540,710,1250,"NATURAL SCIENCE",2.2251,"G"
750,750,1500,"BUSINESS",4,"G"
590,540,1130,"LIBERAL ARTS",2.8764,"G"
520,540,1060,"LIBERAL ARTS",2.8036,"G"
590,540,1130,"LIBERAL ARTS",3.5481,"G"
750,790,1540,"LIBERAL ARTS",4,"G"
630,580,1210,"BUSINESS",3.4016,"G"
760,640,1400,"BUSINESS",3.3741,"G"
670,580,1250,"NATURAL SCIENCE",3.519,"G"
560,660,1220,"ENGINEERING",3.2595,"G"
610,590,1200,"LIBERAL ARTS",2.6724,"G"
540,590,1130,"LIBERAL ARTS",2.3629,"G"
600,690,1290,"ENGINEERING",3.4628,"G"
600,580,1180,"COMMUNICATIONS",3.8174,"G"
570,770,1340,"NATURAL SCIENCE",3.7272,"G"
610,620,1230,"LIBERAL ARTS",3.5289,"G"
550,630,1180,"LIBERAL ARTS",3.0297,"G"
520,610,1130,"EDUCATION",3.7884,"G"
520,560,1080,"NATURAL SCIENCE",2.8055,"G"
640,610,1250,"NATURAL SCIENCE",3.8541,"G"
620,660,1280,"LIBERAL ARTS",3.8405,"G"
560,660,1220,"COMMUNICATIONS",3.82,"G"
620,580,1200,"LIBERAL ARTS",2.9503,"G"
680,790,1470,"BUSINESS",3.8636,"G"
550,760,1310,"ENGINEERING",3.509,"G"
660,790,1450,"NATURAL SCIENCE",3.9787,"G"
630,630,1260,"ENGINEERING",2.7867,"G"
620,770,1390,"ENGINEERING",2.8055,"G"
530,580,1110,"LIBERAL ARTS",2.8813,"G"
650,620,1270,"COMMUNICATIONS",3.1844,"G"
660,600,1260,"LIBERAL ARTS",3.6206,"G"
710,750,1460,"BUSINESS",3.8389,"G"
410,490,900,"FINE ARTS",2.1351,"G"
590,630,1220,"LIBERAL ARTS",2.9268,"G"
580,620,1200,"LIBERAL ARTS",2.1196,"G"
530,480,1010,"NATURAL SCIENCE",3.6,"G"
480,420,900,"FINE ARTS",3.1441,"G"
390,500,890,"LIBERAL ARTS",2.409,"G"
540,590,1130,"ENGINEERING",2.6119,"G"
620,700,1320,"LIBERAL ARTS",3.0294,"G"
690,710,1400,"LIBERAL ARTS",3.514,"G"
630,760,1390,"LIBERAL ARTS",3.7777,"G"
580,400,980,"LIBERAL ARTS",3.3611,"G"
590,500,1090,"LIBERAL ARTS",2.6165,"G"
670,630,1300,"LIBERAL ARTS",3.7569,"G"
650,580,1230,"LIBERAL ARTS",3.6896,"G"
590,580,1170,"LIBERAL ARTS",3.5698,"G"
710,670,1380,"LIBERAL ARTS",3.6974,"G"
560,710,1270,"NATURAL SCIENCE",3.7575,"G"
560,680,1240,"FINE ARTS",2.2347,"G"
510,530,1040,"LIBERAL ARTS",3.0097,"G"
590,550,1140,"NATURAL SCIENCE",3.0526,"G"
620,710,1330,"NATURAL SCIENCE",2.7073,"G"
690,610,1300,"BUSINESS",3.5263,"G"
450,390,840,"NATURAL SCIENCE",2.7058,"G"
550,580,1130,"EDUCATION",3.7326,"G"
530,530,1060,"BUSINESS",2.2454,"G"
630,540,1170,"SOCIAL WORK",3.2972,"G"
720,740,1460,"NATURAL SCIENCE",3.5426,"G"
800,710,1510,"LIBERAL ARTS",3.6392,"G"
540,470,1010,"LIBERAL ARTS",3.25,"G"
530,560,1090,"LIBERAL ARTS",3.0683,"G"
640,700,1340,"NATURAL SCIENCE",2.5596,"G"
670,500,1170,"NATURAL SCIENCE",3.2843,"G"
590,530,1120,"NATURAL SCIENCE",3.4285,"G"
720,660,1380,"BUSINESS",2.8253,"G"
600,560,1160,"LIBERAL ARTS",2.5967,"G"
660,470,1130,"LIBERAL ARTS",3.3505,"G"
610,690,1300,"BUSINESS",3.7978,"G"
540,670,1210,"LIBERAL ARTS",3.4657,"G"
550,610,1160,"LIBERAL ARTS",2.3875,"G"
500,690,1190,"NATURAL SCIENCE",3.02,"G"
530,610,1140,"LIBERAL ARTS",2.6893,"G"
500,610,1110,"LIBERAL ARTS",2.2796,"G"
490,580,1070,"EDUCATION",3.5909,"G"
690,710,1400,"NATURAL SCIENCE",3.2624,"G"
610,510,1120,"LIBERAL ARTS",2.9729,"G"
690,720,1410,"LIBERAL ARTS",3.8536,"G"
630,550,1180,"NATURAL SCIENCE",3.1212,"G"
670,710,1380,"NATURAL SCIENCE",2.8292,"G"
540,510,1050,"LIBERAL ARTS",3.7596,"G"
600,650,1250,"COMMUNICATIONS",3.8651,"G"
790,710,1500,"NATURAL SCIENCE",4,"G"
610,610,1220,"BUSINESS",3.6238,"G"
520,490,1010,"NATURAL SCIENCE",2.5943,"G"
550,540,1090,"LIBERAL ARTS",2.7457,"G"
570,650,1220,"NATURAL SCIENCE",2.6779,"G"
640,660,1300,"BUSINESS",3.9693,"G"
590,560,1150,"LIBERAL ARTS",2.8309,"G"
670,560,1230,"NATURAL SCIENCE",3.4741,"G"
680,640,1320,"LIBERAL ARTS",3.9256,"G"
570,580,1150,"NATURAL SCIENCE",3.4,"G"
610,740,1350,"BUSINESS",2.5793,"G"
550,620,1170,"FINE ARTS",3.5537,"G"
570,640,1210,"BUSINESS",3.2432,"G"
700,790,1490,"ENGINEERING",3.5675,"G"
640,630,1270,"LIBERAL ARTS",3.3809,"G"
690,680,1370,"NATURAL SCIENCE",2.8981,"G"
610,630,1240,"LIBERAL ARTS",2.7946,"G"
470,530,1000,"LIBERAL ARTS",2.1975,"G"
460,440,900,"NATURAL SCIENCE",2.9291,"G"
530,600,1130,"LIBERAL ARTS",2.7407,"G"
650,660,1310,"LIBERAL ARTS",3.6902,"G"
520,590,1110,"EDUCATION",3.0454,"G"
640,550,1190,"LIBERAL ARTS",3.1696,"G"
620,720,1340,"ENGINEERING",3.4407,"G"
800,800,1600,"COMMUNICATIONS",3.9788,"G"
780,740,1520,"LIBERAL ARTS",3.8275,"G"
570,650,1220,"ENGINEERING",3.6124,"G"
620,660,1280,"ENGINEERING",3.3417,"G"
660,690,1350,"NATURAL SCIENCE",2.6178,"G"
660,560,1220,"LIBERAL ARTS",3.7647,"G"
650,410,1060,"NURSING",2.7187,"G"
610,640,1250,"LIBERAL ARTS",3.8305,"G"
670,650,1320,"LIBERAL ARTS",3.7761,"G"
490,470,960,"NATURAL SCIENCE",2.5092,"G"
630,540,1170,"EDUCATION",3.9142,"G"
760,740,1500,"BUSINESS",3.9366,"G"
530,620,1150,"LIBERAL ARTS",3.5504,"G"
470,550,1020,"LIBERAL ARTS",2.8437,"G"
510,500,1010,"EDUCATION",3.3711,"G"
770,540,1310,"NATURAL SCIENCE",2.9565,"G"
560,540,1100,"LIBERAL ARTS",2.4545,"G"
330,440,770,"NATURAL SCIENCE",2.6386,"G"
500,490,990,"BUSINESS",3.4736,"G"
610,660,1270,"ENGINEERING",3.184,"G"
540,710,1250,"ARCHITECTURE",3.2,"G"
640,640,1280,"LIBERAL ARTS",3.2314,"G"
630,710,1340,"BUSINESS",4,"G"
640,680,1320,"BUSINESS",3.9687,"G"
620,690,1310,"ENGINEERING",3.3228,"G"
630,510,1140,"LIBERAL ARTS",3.2222,"G"
510,490,1000,"LIBERAL ARTS",2.8,"G"
730,620,1350,"BUSINESS",3.9065,"G"
770,620,1390,"LIBERAL ARTS",3.5271,"G"
540,650,1190,"SOCIAL WORK",2.6101,"G"
560,600,1160,"LIBERAL ARTS",3.7094,"G"
540,590,1130,"NATURAL SCIENCE",3.5921,"G"
660,770,1430,"BUSINESS",3.621,"G"
620,550,1170,"NATURAL SCIENCE",2.9338,"G"
560,700,1260,"BUSINESS",3.56,"G"
480,560,1040,"BUSINESS",2.8877,"G"
510,480,990,"LIBERAL ARTS",2.554,"G"
630,640,1270,"COMMUNICATIONS",3.3103,"G"
560,670,1230,"FINE ARTS",3.7058,"G"
800,720,1520,"BUSINESS",3.928,"G"
600,660,1260,"LIBERAL ARTS",2.5123,"G"
800,720,1520,"LIBERAL ARTS",3.8355,"G"
660,710,1370,"ENGINEERING",3.5074,"G"
580,680,1260,"ENGINEERING",3.8623,"G"
670,720,1390,"FINE ARTS",3.826,"G"
710,700,1410,"NATURAL SCIENCE",2.1796,"G"
570,560,1130,"LIBERAL ARTS",3.85,"G"
640,580,1220,"NATURAL SCIENCE",3.4379,"G"
440,620,1060,"ENGINEERING",1.9793,"G"
640,520,1160,"LIBERAL ARTS",2.7685,"G"
570,670,1240,"EDUCATION",3.3533,"G"
560,630,1190,"NATURAL SCIENCE",2.9166,"G"
530,580,1110,"LIBERAL ARTS",2.8648,"G"
690,720,1410,"NATURAL SCIENCE",3.2111,"G"
500,640,1140,"ENGINEERING",2.2671,"G"
720,650,1370,"COMMUNICATIONS",3.3628,"G"
490,450,940,"LIBERAL ARTS",3.8055,"G"
480,640,1120,"NATURAL SCIENCE",3.115,"G"
570,530,1100,"LIBERAL ARTS",2.9917,"G"
650,770,1420,"BUSINESS",3.6776,"G"
730,790,1520,"ARCHITECTURE",3.4259,"G"
580,710,1290,"NATURAL SCIENCE",3.3783,"G"
680,640,1320,"NATURAL SCIENCE",3.2384,"G"
520,640,1160,"LIBERAL ARTS",3.1844,"G"
640,470,1110,"LIBERAL ARTS",3.303,"G"
640,700,1340,"FINE ARTS",2.9682,"G"
610,520,1130,"LIBERAL ARTS",2.4653,"G"
510,670,1180,"BUSINESS",3.3596,"G"
650,770,1420,"ENGINEERING",2.7894,"G"
510,610,1120,"LIBERAL ARTS",2.6938,"G"
470,530,1000,"LIBERAL ARTS",3.5714,"G"
620,560,1180,"LIBERAL ARTS",3.2,"G"
600,630,1230,"COMMUNICATIONS",3.7157,"G"
520,630,1150,"FINE ARTS",3.5631,"G"
720,710,1430,"ENGINEERING",3.2039,"G"
510,520,1030,"COMMUNICATIONS",3.49,"G"
630,490,1120,"BUSINESS",3.5535,"G"
530,540,1070,"EDUCATION",3.5531,"G"
610,550,1160,"COMMUNICATIONS",3.7835,"G"
600,650,1250,"LIBERAL ARTS",2.9449,"G"
700,680,1380,"BUSINESS",3.9729,"G"
610,540,1150,"NATURAL SCIENCE",2.6025,"G"
490,520,1010,"LIBERAL ARTS",2.0074,"G"
580,530,1110,"BUSINESS",2.9763,"G"
620,680,1300,"LIBERAL ARTS",3.4274,"G"
530,620,1150,"ENGINEERING",3.2887,"G"
490,540,1030,"NATURAL SCIENCE",3.2881,"G"
650,440,1090,"LIBERAL ARTS",3.5169,"G"
690,710,1400,"ENGINEERING",3.6421,"G"
600,670,1270,"NATURAL SCIENCE",2.475,"G"
670,620,1290,"BUSINESS",3.2783,"G"
560,640,1200,"LIBERAL ARTS",2.5769,"G"
660,680,1340,"BUSINESS",4,"G"
620,530,1150,"NATURAL SCIENCE",3.4,"G"
580,460,1040,"COMMUNICATIONS",3.2807,"G"
580,630,1210,"LIBERAL ARTS",3.1578,"G"
520,590,1110,"LIBERAL ARTS",3.8019,"G"
680,710,1390,"BUSINESS",3.7446,"G"
500,500,1000,"EDUCATION",3.2708,"G"
660,690,1350,"ENGINEERING",3.2531,"G"
580,610,1190,"LIBERAL ARTS",3.2666,"G"
730,740,1470,"BUSINESS",3.7555,"G"
510,560,1070,"NATURAL SCIENCE",3.4042,"G"
650,680,1330,"LIBERAL ARTS",3.689,"G"
480,440,920,"COMMUNICATIONS",2.7596,"G"
530,570,1100,"LIBERAL ARTS",3.1391,"G"
440,550,990,"BUSINESS",3.2912,"G"
580,550,1130,"LIBERAL ARTS",2.991,"G"
560,520,1080,"LIBERAL ARTS",2.4782,"G"
550,700,1250,"ENGINEERING",2.2222,"G"
550,720,1270,"NATURAL SCIENCE",2.6324,"G"
580,640,1220,"BUSINESS",3.6756,"G"
750,630,1380,"COMMUNICATIONS",3.909,"G"
660,800,1460,"ENGINEERING",3.6013,"G"
530,540,1070,"EDUCATION",3.8867,"G"
610,640,1250,"LIBERAL ARTS",3.5148,"G"
630,490,1120,"ENGINEERING",3.3571,"G"
590,600,1190,"LIBERAL ARTS",3.0384,"G"
440,570,1010,"NATURAL SCIENCE",3.4036,"G"
540,600,1140,"LIBERAL ARTS",2.6774,"G"
750,740,1490,"LIBERAL ARTS",3.9752,"G"
690,700,1390,"LIBERAL ARTS",3.8598,"G"
540,470,1010,"COMMUNICATIONS",3.423,"G"
520,580,1100,"EDUCATION",3.4434,"G"
520,550,1070,"LIBERAL ARTS",3.5217,"G"
510,530,1040,"EDUCATION",3.2909,"G"
570,520,1090,"BUSINESS",2.8111,"G"
400,460,860,"BUSINESS",2.3669,"G"
630,530,1160,"COMMUNICATIONS",3.6509,"G"
680,670,1350,"LIBERAL ARTS",3.4583,"G"
520,550,1070,"NATURAL SCIENCE",3.9405,"G"
700,620,1320,"FINE ARTS",3.0526,"G"
510,520,1030,"EDUCATION",3.43,"G"
590,690,1280,"ENGINEERING",3,"G"
420,440,860,"EDUCATION",3.0873,"G"
520,450,970,"COMMUNICATIONS",2.6279,"G"
540,580,1120,"LIBERAL ARTS",2.7066,"G"
640,560,1200,"LIBERAL ARTS",3.6834,"G"
470,680,1150,"LIBERAL ARTS",2.8181,"G"
600,640,1240,"LIBERAL ARTS",3.4159,"G"
620,630,1250,"LIBERAL ARTS",3.6739,"G"
520,570,1090,"EDUCATION",1.9328,"G"
500,600,1100,"NATURAL SCIENCE",2.7164,"G"
620,740,1360,"ENGINEERING",2.6204,"G"
610,790,1400,"BUSINESS",3.202,"G"
610,580,1190,"BUSINESS",2.5555,"G"
480,440,920,"LIBERAL ARTS",3.0089,"G"
640,520,1160,"NATURAL SCIENCE",3.155,"G"
760,710,1470,"BUSINESS",3.5289,"G"
450,580,1030,"LIBERAL ARTS",3.396,"G"
480,560,1040,"COMMUNICATIONS",2.9639,"G"
490,490,980,"BUSINESS",2.9263,"G"
670,670,1340,"LIBERAL ARTS",2.5915,"G"
580,760,1340,"LIBERAL ARTS",2.8979,"G"
720,700,1420,"NATURAL SCIENCE",3.872,"G"
760,750,1510,"LIBERAL ARTS",3.9307,"G"
620,540,1160,"NATURAL SCIENCE",3.9464,"G"
550,480,1030,"COMMUNICATIONS",3.7352,"G"
430,350,780,"NURSING",3.1176,"G"
550,480,1030,"EDUCATION",3.1428,"G"
590,650,1240,"LIBERAL ARTS",2.8727,"G"
500,510,1010,"BUSINESS",3.2698,"G"
630,550,1180,"LIBERAL ARTS",3.2743,"G"
550,610,1160,"BUSINESS",2.5669,"G"
620,650,1270,"LIBERAL ARTS",2.9545,"G"
610,590,1200,"NATURAL SCIENCE",3.0806,"G"
520,590,1110,"ENGINEERING",2.6488,"G"
690,650,1340,"NATURAL SCIENCE",3.4939,"G"
470,620,1090,"LIBERAL ARTS",3.6285,"G"
530,600,1130,"LIBERAL ARTS",2.8787,"G"
730,680,1410,"LIBERAL ARTS",3.8548,"G"
520,600,1120,"LIBERAL ARTS",2.4569,"G"
640,730,1370,"COMMUNICATIONS",2.6946,"G"
680,640,1320,"BUSINESS",3.1833,"G"
680,600,1280,"SOCIAL WORK",3.5698,"G"
630,710,1340,"NATURAL SCIENCE",2.9268,"G"
620,700,1320,"LIBERAL ARTS",2.99,"G"
490,460,950,"LIBERAL ARTS",2.2573,"G"
570,650,1220,"NATURAL SCIENCE",3.6363,"G"
510,630,1140,"LIBERAL ARTS",3.536,"G"
390,480,870,"NATURAL SCIENCE",2.1398,"G"
550,560,1110,"LIBERAL ARTS",3.6574,"G"
470,540,1010,"FINE ARTS",2.9491,"G"
540,560,1100,"BUSINESS",2.7311,"G"
600,630,1230,"NATURAL SCIENCE",2.6513,"G"
620,580,1200,"COMMUNICATIONS",3.349,"G"
590,590,1180,"NATURAL SCIENCE",3.488,"G"
690,660,1350,"LIBERAL ARTS",3.2517,"G"
690,680,1370,"LIBERAL ARTS",3.9055,"G"
520,470,990,"LIBERAL ARTS",2.5775,"G"
720,660,1380,"ENGINEERING",2.7956,"G"
600,600,1200,"LIBERAL ARTS",3.5223,"G"
640,670,1310,"BUSINESS",3.5086,"G"
540,560,1100,"NATURAL SCIENCE",2.4107,"G"
510,430,940,"LIBERAL ARTS",3.5663,"G"
700,580,1280,"COMMUNICATIONS",3.3009,"G"
650,650,1300,"COMMUNICATIONS",3.2056,"G"
650,650,1300,"FINE ARTS",3.3305,"G"
600,480,1080,"FINE ARTS",3.3431,"G"
610,710,1320,"LIBERAL ARTS",2.3807,"G"
620,640,1260,"LIBERAL ARTS",3.5049,"G"
750,570,1320,"LIBERAL ARTS",2.9406,"G"
470,650,1120,"LIBERAL ARTS",3.0529,"G"
660,610,1270,"COMMUNICATIONS",3.7604,"G"
660,540,1200,"LIBERAL ARTS",3.31,"G"
590,510,1100,"NATURAL SCIENCE",2.4545,"G"
710,510,1220,"LIBERAL ARTS",3.59,"G"
550,500,1050,"LIBERAL ARTS",2.4354,"G"
700,720,1420,"NATURAL SCIENCE",3.8607,"G"
670,770,1440,"BUSINESS",3.9702,"G"
650,620,1270,"NATURAL SCIENCE",3.5433,"G"
610,550,1160,"ENGINEERING",3.5063,"G"
670,660,1330,"NATURAL SCIENCE",2.9911,"G"
660,620,1280,"NURSING",2.4915,"G"
630,690,1320,"LIBERAL ARTS",3.5288,"G"
410,520,930,"NATURAL SCIENCE",2.9482,"G"
560,670,1230,"SOCIAL WORK",3.7416,"G"
790,710,1500,"NATURAL SCIENCE",3.9754,"G"
650,690,1340,"BUSINESS",3.8333,"G"
500,560,1060,"COMMUNICATIONS",3.2244,"G"
570,660,1230,"ENGINEERING",3.6917,"G"
440,380,820,"BUSINESS",3.504,"G"
660,600,1260,"NATURAL SCIENCE",3.5537,"G"
510,550,1060,"BUSINESS",3.3292,"G"
640,640,1280,"BUSINESS",3.7416,"G"
470,610,1080,"LIBERAL ARTS",3.0461,"G"
610,770,1380,"ENGINEERING",3.7037,"G"
650,590,1240,"BUSINESS",3.3626,"G"
540,690,1230,"LIBERAL ARTS",3.1926,"G"
490,600,1090,"LIBERAL ARTS",3.29,"G"
510,630,1140,"NATURAL SCIENCE",2.4285,"G"
470,490,960,"BUSINESS",2.9009,"G"
580,560,1140,"NATURAL SCIENCE",3.3821,"G"
550,640,1190,"LIBERAL ARTS",2.8762,"G"
670,630,1300,"BUSINESS",3.7768,"G"
630,590,1220,"ENGINEERING",2.6616,"G"
790,700,1490,"FINE ARTS",4,"G"
770,740,1510,"ENGINEERING",3.9154,"G"
460,680,1140,"BUSINESS",3.1681,"G"
620,620,1240,"COMMUNICATIONS",3.2211,"G"
530,510,1040,"LIBERAL ARTS",2.9259,"G"
570,710,1280,"ENGINEERING",3.5354,"G"
580,650,1230,"ENGINEERING",3.2828,"G"
630,550,1180,"BUSINESS",3.6603,"G"
610,590,1200,"BUSINESS",3.5,"G"
610,510,1120,"NATURAL SCIENCE",3.584,"G"
500,530,1030,"LIBERAL ARTS",2.1858,"G"
600,700,1300,"LIBERAL ARTS",3.3157,"G"
650,690,1340,"ENGINEERING",3.144,"G"
580,600,1180,"LIBERAL ARTS",3.032,"G"
490,550,1040,"FINE ARTS",2.4285,"G"
570,520,1090,"COMMUNICATIONS",3.1984,"G"
600,590,1190,"COMMUNICATIONS",2.5769,"G"
690,620,1310,"COMMUNICATIONS",3.3265,"G"
560,590,1150,"LIBERAL ARTS",3.3115,"G"
540,690,1230,"LIBERAL ARTS",3.6106,"G"
640,630,1270,"NATURAL SCIENCE",3.9736,"G"
560,560,1120,"LIBERAL ARTS",2.2844,"G"
540,620,1160,"NATURAL SCIENCE",2.6101,"G"
500,540,1040,"EDUCATION",2.106,"G"
740,610,1350,"LIBERAL ARTS",3.0866,"G"
690,660,1350,"BUSINESS",3.8823,"G"
730,790,1520,"BUSINESS",3.8181,"G"
580,440,1020,"LIBERAL ARTS",2.686,"G"
480,510,990,"LIBERAL ARTS",3.741,"G"
520,700,1220,"LIBERAL ARTS",3.3628,"G"
590,570,1160,"BUSINESS",3.542,"G"
620,620,1240,"FINE ARTS",3.5,"G"
540,570,1110,"LIBERAL ARTS",2.77,"G"
650,680,1330,"FINE ARTS",3.4649,"G"
710,800,1510,"ENGINEERING",3.915,"G"
570,560,1130,"LIBERAL ARTS",2.9528,"G"
780,790,1570,"ENGINEERING",3.9718,"G"
390,460,850,"LIBERAL ARTS",2.8814,"G"
640,700,1340,"NATURAL SCIENCE",3.3965,"G"
780,740,1520,"ENGINEERING",3.3493,"G"
630,650,1280,"ENGINEERING",3.5294,"G"
430,620,1050,"ENGINEERING",2.3795,"G"
650,700,1350,"LIBERAL ARTS",3.3185,"G"
710,650,1360,"LIBERAL ARTS",3.3333,"G"
650,580,1230,"LIBERAL ARTS",3.5922,"G"
620,780,1400,"ENGINEERING",3.587,"G"
590,700,1290,"NATURAL SCIENCE",3,"G"
630,540,1170,"LIBERAL ARTS",3.9534,"G"
570,550,1120,"FINE ARTS",3.0675,"G"
720,800,1520,"BUSINESS",2.936,"G"
510,500,1010,"LIBERAL ARTS",2.625,"G"
590,640,1230,"LIBERAL ARTS",3.134,"G"
520,550,1070,"COMMUNICATIONS",4,"G"
510,520,1030,"LIBERAL ARTS",2.9642,"G"
490,520,1010,"EDUCATION",3.4214,"G"
520,670,1190,"LIBERAL ARTS",3.1346,"G"
590,610,1200,"NATURAL SCIENCE",3.3507,"G"
590,660,1250,"LIBERAL ARTS",3.0744,"G"
670,620,1290,"COMMUNICATIONS",3.7473,"G"
720,640,1360,"BUSINESS",3.918,"G"
560,620,1180,"LIBERAL ARTS",3.009,"G"
490,550,1040,"LIBERAL ARTS",3.0333,"G"
630,620,1250,"ENGINEERING",2.4519,"G"
560,620,1180,"NATURAL SCIENCE",3.248,"G"
490,550,1040,"BUSINESS",2.7706,"G"
650,660,1310,"BUSINESS",3.5048,"G"
510,540,1050,"LIBERAL ARTS",3.7735,"G"
550,580,1130,"LIBERAL ARTS",2.7438,"G"
680,620,1300,"LIBERAL ARTS",2.2807,"G"
550,640,1190,"NATURAL SCIENCE",3.4779,"G"
680,660,1340,"LIBERAL ARTS",2.8842,"G"
560,700,1260,"ENGINEERING",3.7627,"G"
500,570,1070,"EDUCATION",2.7647,"G"
580,630,1210,"ENGINEERING",3.9264,"G"
530,600,1130,"LIBERAL ARTS",3.3777,"G"
530,560,1090,"NATURAL SCIENCE",2.96,"G"
600,770,1370,"ENGINEERING",2.8181,"G"
750,740,1490,"NATURAL SCIENCE",3.6622,"G"
530,570,1100,"BUSINESS",3.2666,"G"
780,720,1500,"ENGINEERING",3.8496,"G"
450,470,920,"BUSINESS",3.0185,"G"
580,560,1140,"LIBERAL ARTS",3.2608,"G"
670,620,1290,"COMMUNICATIONS",3.55,"G"
590,630,1220,"LIBERAL ARTS",3.6736,"G"
480,480,960,"LIBERAL ARTS",2.5312,"G"
620,600,1220,"LIBERAL ARTS",3.2893,"G"
530,590,1120,"LIBERAL ARTS",3.5794,"G"
700,690,1390,"ENGINEERING",3.4172,"G"
650,730,1380,"LIBERAL ARTS",3.7663,"G"
560,550,1110,"LIBERAL ARTS",3.3839,"G"
650,670,1320,"LIBERAL ARTS",3.6533,"G"
580,570,1150,"BUSINESS",2.475,"G"
530,520,1050,"LIBERAL ARTS",2.8508,"G"
630,610,1240,"LIBERAL ARTS",3.1194,"G"
490,510,1000,"LIBERAL ARTS",3.6206,"G"
520,520,1040,"LIBERAL ARTS",2.6014,"G"
580,520,1100,"BUSINESS",2.8333,"G"
640,700,1340,"ENGINEERING",3.379,"G"
680,650,1330,"NATURAL SCIENCE",3.3896,"G"
520,690,1210,"NATURAL SCIENCE",2.5491,"G"
770,790,1560,"ENGINEERING",3.6927,"G"
480,640,1120,"NATURAL SCIENCE",3,"G"
680,660,1340,"ENGINEERING",3.181,"G"
660,690,1350,"COMMUNICATIONS",3.8195,"G"
530,600,1130,"NATURAL SCIENCE",2.5725,"G"
650,680,1330,"LIBERAL ARTS",3.4893,"G"
720,700,1420,"BUSINESS",3.8189,"G"
580,550,1130,"NATURAL SCIENCE",3.1,"G"
520,550,1070,"EDUCATION",3.1897,"G"
660,690,1350,"NATURAL SCIENCE",3.8148,"G"
640,640,1280,"LIBERAL ARTS",3.5327,"G"
690,710,1400,"NATURAL SCIENCE",3.6666,"G"
390,470,860,"FINE ARTS",3.1739,"G"
640,660,1300,"EDUCATION",3.6737,"G"
490,550,1040,"BUSINESS",3.307,"G"
530,670,1200,"NATURAL SCIENCE",2.5954,"G"
690,690,1380,"LIBERAL ARTS",3.5428,"G"
620,670,1290,"NATURAL SCIENCE",2.3787,"G"
660,630,1290,"NATURAL SCIENCE",2.6016,"G"
570,590,1160,"LIBERAL ARTS",2.1103,"G"
560,620,1180,"BUSINESS",3.0176,"G"
720,740,1460,"NATURAL SCIENCE",3.2857,"G"
510,490,1000,"LIBERAL ARTS",3.5428,"G"
640,650,1290,"NATURAL SCIENCE",3.9752,"G"
710,800,1510,"NATURAL SCIENCE",3.075,"G"
660,610,1270,"BUSINESS",3.1826,"G"
560,590,1150,"LIBERAL ARTS",2.6587,"G"
640,670,1310,"LIBERAL ARTS",2.8677,"G"
520,620,1140,"BUSINESS",3.1956,"G"
650,680,1330,"LIBERAL ARTS",2.9805,"G"
540,510,1050,"LIBERAL ARTS",3.4375,"G"
650,600,1250,"NATURAL SCIENCE",3.09,"G"
490,610,1100,"NATURAL SCIENCE",3.2977,"G"
560,690,1250,"NATURAL SCIENCE",3.4777,"G"
540,620,1160,"BUSINESS",2.3106,"G"
620,680,1300,"BUSINESS",3.9237,"G"
540,530,1070,"LIBERAL ARTS",3.375,"G"
550,480,1030,"NATURAL SCIENCE",2.689,"G"
570,650,1220,"BUSINESS",3.0113,"G"
510,620,1130,"LIBERAL ARTS",2.2941,"G"
590,580,1170,"LIBERAL ARTS",2.7656,"G"
470,470,940,"LIBERAL ARTS",3.0461,"G"
510,540,1050,"LIBERAL ARTS",2.4545,"G"
700,740,1440,"NATURAL SCIENCE",3.8217,"G"
710,790,1500,"LIBERAL ARTS",3.2881,"G"
520,530,1050,"COMMUNICATIONS",2.7565,"G"
680,650,1330,"NATURAL SCIENCE",3.6326,"G"
610,570,1180,"NATURAL SCIENCE",2.5652,"G"
610,640,1250,"LIBERAL ARTS",3.4454,"G"
500,560,1060,"LIBERAL ARTS",3.4897,"G"
450,540,990,"LIBERAL ARTS",2.4793,"G"
540,610,1150,"BUSINESS",3.372,"G"
710,650,1360,"FINE ARTS",3.5114,"G"
690,720,1410,"ENGINEERING",3.921,"G"
420,510,930,"BUSINESS",2.5959,"G"
500,620,1120,"LIBERAL ARTS",2.6301,"G"
600,650,1250,"NATURAL SCIENCE",3.1869,"G"
580,490,1070,"BUSINESS",2.9247,"G"
450,600,1050,"LIBERAL ARTS",2.2522,"G"
590,690,1280,"BUSINESS",3.9181,"G"
680,640,1320,"BUSINESS",3.2833,"G"
540,720,1260,"BUSINESS",3.5757,"G"
590,630,1220,"LIBERAL ARTS",2.1186,"G"
490,540,1030,"LIBERAL ARTS",2.5,"G"
660,740,1400,"NATURAL SCIENCE",3.975,"G"
590,540,1130,"NATURAL SCIENCE",3.5042,"G"
550,630,1180,"COMMUNICATIONS",3.2142,"G"
730,640,1370,"LIBERAL ARTS",3.5454,"G"
610,630,1240,"LIBERAL ARTS",3.173,"G"
520,490,1010,"COMMUNICATIONS",2.7727,"G"
500,570,1070,"LIBERAL ARTS",2.6379,"G"
500,590,1090,"BUSINESS",3.2929,"G"
670,630,1300,"BUSINESS",3.1443,"G"
620,630,1250,"LIBERAL ARTS",3.1217,"G"
540,520,1060,"ENGINEERING",2.6666,"G"
620,660,1280,"ENGINEERING",3.8524,"G"
580,620,1200,"BUSINESS",3.8489,"G"
490,600,1090,"LIBERAL ARTS",2.7225,"G"
530,480,1010,"NATURAL SCIENCE",3.8217,"G"
690,600,1290,"NATURAL SCIENCE",3.2478,"G"
730,650,1380,"LIBERAL ARTS",2.7352,"G"
690,510,1200,"BUSINESS",3.1826,"G"
690,610,1300,"FINE ARTS",3.9495,"G"
600,690,1290,"ENGINEERING",2.3259,"G"
500,570,1070,"LIBERAL ARTS",2.8606,"G"
540,530,1070,"NATURAL SCIENCE",3.0844,"G"
630,670,1300,"ENGINEERING",3.7766,"G"
630,530,1160,"LIBERAL ARTS",3.0789,"G"
800,790,1590,"NATURAL SCIENCE",3.1016,"G"
600,670,1270,"LIBERAL ARTS",2.9596,"G"
620,750,1370,"ENGINEERING",4,"G"
680,630,1310,"LIBERAL ARTS",3.8811,"G"
520,590,1110,"BUSINESS",2.7368,"G"
530,620,1150,"COMMUNICATIONS",3.1018,"G"
760,640,1400,"ENGINEERING",2.9424,"G"
610,710,1320,"BUSINESS",3.5135,"G"
550,630,1180,"NATURAL SCIENCE",2.8947,"G"
410,430,840,"NATURAL SCIENCE",2.448,"G"
580,470,1050,"EDUCATION",3.5932,"G"
600,470,1070,"NATURAL SCIENCE",2.9098,"G"
530,450,980,"LIBERAL ARTS",2.8224,"G"
550,490,1040,"LIBERAL ARTS",3.5096,"G"
550,490,1040,"NATURAL SCIENCE",3.0224,"G"
770,720,1490,"BUSINESS",3.7559,"G"
710,740,1450,"LIBERAL ARTS",2.8936,"G"
670,590,1260,"LIBERAL ARTS",3.9724,"G"
580,680,1260,"ENGINEERING",2.8037,"G"
500,600,1100,"ENGINEERING",3.2291,"G"
610,610,1220,"ENGINEERING",3.125,"G"
530,540,1070,"LIBERAL ARTS",2.9666,"G"
780,690,1470,"COMMUNICATIONS",3.5454,"G"
620,550,1170,"BUSINESS",3.0224,"G"
670,610,1280,"BUSINESS",3.7977,"G"
600,670,1270,"NATURAL SCIENCE",3.4732,"G"
560,590,1150,"NATURAL SCIENCE",3.4062,"G"
490,560,1050,"ENGINEERING",2.8444,"G"
610,590,1200,"LIBERAL ARTS",3.2371,"G"
570,580,1150,"LIBERAL ARTS",3.8878,"G"
600,620,1220,"NATURAL SCIENCE",2.6461,"G"
540,530,1070,"EDUCATION",3.2,"G"
630,590,1220,"NATURAL SCIENCE",3.5761,"G"
620,680,1300,"COMMUNICATIONS",3.88,"G"
580,620,1200,"NATURAL SCIENCE",2.2018,"G"
680,790,1470,"BUSINESS",3.6551,"G"
560,510,1070,"NATURAL SCIENCE",2.59,"G"
530,590,1120,"LIBERAL ARTS",2.0796,"G"
440,600,1040,"LIBERAL ARTS",2.559,"G"
630,580,1210,"LIBERAL ARTS",3.32,"G"
550,570,1120,"LIBERAL ARTS",3.271,"G"
440,620,1060,"ENGINEERING",2.7685,"G"
620,560,1180,"LIBERAL ARTS",3.2268,"G"
570,630,1200,"ENGINEERING",3.719,"G"
540,610,1150,"ENGINEERING",3.2272,"G"
610,520,1130,"LIBERAL ARTS",3.8988,"G"
650,620,1270,"COMMUNICATIONS",3.6702,"G"
540,670,1210,"LIBERAL ARTS",3.6428,"G"
660,680,1340,"BUSINESS",3.8686,"G"
530,550,1080,"NATURAL SCIENCE",3.3619,"G"
610,500,1110,"LIBERAL ARTS",2.7777,"G"
510,620,1130,"LIBERAL ARTS",2.5454,"G"
530,700,1230,"NATURAL SCIENCE",4,"G"
560,530,1090,"BUSINESS",3.6806,"G"
640,600,1240,"LIBERAL ARTS",2.7722,"G"
560,650,1210,"NATURAL SCIENCE",2.9368,"G"
540,520,1060,"NATURAL SCIENCE",3.1785,"G"
790,680,1470,"LIBERAL ARTS",3.5888,"G"
580,690,1270,"ENGINEERING",2.8846,"G"
690,600,1290,"LIBERAL ARTS",3.2155,"G"
650,680,1330,"NATURAL SCIENCE",3.7047,"G"
520,570,1090,"LIBERAL ARTS",2.9669,"G"
480,540,1020,"LIBERAL ARTS",2.6065,"G"
700,660,1360,"BUSINESS",3.76,"G"
530,610,1140,"ENGINEERING",2.6134,"G"
600,610,1210,"NATURAL SCIENCE",2.8969,"G"
620,670,1290,"BUSINESS",3.2831,"G"
700,740,1440,"ENGINEERING",3.4661,"G"
590,790,1380,"LIBERAL ARTS",3.9021,"G"
610,600,1210,"LIBERAL ARTS",2.7745,"G"
800,650,1450,"COMMUNICATIONS",2.4393,"G"
570,590,1160,"NATURAL SCIENCE",2.8333,"G"
620,590,1210,"LIBERAL ARTS",3.0932,"G"
510,520,1030,"EDUCATION",3.2105,"G"
670,610,1280,"COMMUNICATIONS",3.8295,"G"
670,640,1310,"LIBERAL ARTS",3.7157,"G"
510,510,1020,"EDUCATION",3.1818,"G"
650,650,1300,"EDUCATION",2.6804,"G"
610,620,1230,"BUSINESS",2.7767,"G"
590,650,1240,"NATURAL SCIENCE",2.8818,"G"
800,690,1490,"LIBERAL ARTS",3.8717,"G"
680,740,1420,"NATURAL SCIENCE",2.8076,"G"
470,580,1050,"ENGINEERING",2.8905,"G"
540,650,1190,"LIBERAL ARTS",3.915,"G"
600,540,1140,"COMMUNICATIONS",3.0693,"G"
480,510,990,"NATURAL SCIENCE",2.851,"G"
600,590,1190,"LIBERAL ARTS",3.495,"G"
480,620,1100,"LIBERAL ARTS",2.408,"G"
540,670,1210,"ENGINEERING",2.7049,"G"
600,660,1260,"LIBERAL ARTS",3.2417,"G"
460,530,990,"LIBERAL ARTS",3.0442,"G"
660,640,1300,"BUSINESS",3.3083,"G"
680,630,1310,"NATURAL SCIENCE",3.8666,"G"
510,610,1120,"FINE ARTS",2.3623,"G"
640,540,1180,"BUSINESS",3.0192,"G"
600,670,1270,"LIBERAL ARTS",3.0517,"G"
570,740,1310,"BUSINESS",3.6224,"G"
510,660,1170,"NATURAL SCIENCE",3.258,"G"
610,560,1170,"BUSINESS",3.1588,"G"
730,720,1450,"ENGINEERING",3.9469,"G"
480,490,970,"FINE ARTS",2.8141,"G"
540,510,1050,"LIBERAL ARTS",2.875,"G"
570,500,1070,"FINE ARTS",3.157,"G"
610,610,1220,"BUSINESS",3.0091,"G"
640,690,1330,"ENGINEERING",3.2638,"G"
560,590,1150,"ENGINEERING",3.6875,"G"
570,450,1020,"LIBERAL ARTS",3.7523,"G"
500,570,1070,"ENGINEERING",3.5137,"G"
450,620,1070,"LIBERAL ARTS",3.0937,"G"
610,480,1090,"COMMUNICATIONS",3.1944,"G"
460,570,1030,"NATURAL SCIENCE",2.6275,"G"
570,610,1180,"NATURAL SCIENCE",3.427,"G"
590,640,1230,"LIBERAL ARTS",3.4657,"G"
600,700,1300,"BUSINESS",3.0901,"G"
410,520,930,"BUSINESS",2.6504,"G"
670,540,1210,"COMMUNICATIONS",3.6213,"G"
720,720,1440,"BUSINESS",3.9391,"G"
650,540,1190,"LIBERAL ARTS",2.74,"G"
600,670,1270,"LIBERAL ARTS",2.2408,"G"
710,670,1380,"ENGINEERING",3.9674,"G"
570,710,1280,"FINE ARTS",3.6267,"G"
660,750,1410,"BUSINESS",3.2231,"G"
570,560,1130,"NATURAL SCIENCE",2.7153,"G"
580,550,1130,"NURSING",2.7641,"G"
530,620,1150,"BUSINESS",3.7684,"G"
600,430,1030,"LIBERAL ARTS",3.0583,"G"
690,650,1340,"ENGINEERING",2.8318,"G"
690,580,1270,"NATURAL SCIENCE",2.8192,"G"
440,530,970,"LIBERAL ARTS",2.8469,"G"
500,380,880,"EDUCATION",3.6,"G"
540,570,1110,"LIBERAL ARTS",3.3387,"G"
500,460,960,"NATURAL SCIENCE",2.1172,"G"
580,590,1170,"LIBERAL ARTS",2.7804,"G"
610,630,1240,"LIBERAL ARTS",3.9117,"G"
570,440,1010,"EDUCATION",3.3609,"G"
570,480,1050,"BUSINESS",2.5245,"G"
760,630,1390,"NATURAL SCIENCE",3.0294,"G"
630,660,1290,"LIBERAL ARTS",2.8953,"G"
510,610,1120,"LIBERAL ARTS",3.5,"G"
580,630,1210,"BUSINESS",3.4158,"G"
650,700,1350,"BUSINESS",3.5528,"G"
570,530,1100,"EDUCATION",3.0172,"G"
500,520,1020,"LIBERAL ARTS",2.959,"G"
580,440,1020,"LIBERAL ARTS",2.7578,"G"
640,670,1310,"BUSINESS",3.9417,"G"
690,710,1400,"NATURAL SCIENCE",3.9381,"G"
510,520,1030,"ENGINEERING",2.6391,"G"
650,590,1240,"BUSINESS",3.0588,"G"
590,650,1240,"ENGINEERING",3.2706,"G"
710,630,1340,"BUSINESS",3.3577,"G"
530,530,1060,"BUSINESS",3.2673,"G"
560,520,1080,"LIBERAL ARTS",3.25,"G"
530,530,1060,"LIBERAL ARTS",2.9349,"G"
710,690,1400,"LIBERAL ARTS",3.4538,"G"
660,660,1320,"LIBERAL ARTS",3.0288,"G"
530,560,1090,"COMMUNICATIONS",3.1333,"G"
630,610,1240,"LIBERAL ARTS",3.6069,"G"
580,610,1190,"LIBERAL ARTS",2.9134,"G"
610,590,1200,"LIBERAL ARTS",3.2307,"G"
680,710,1390,"LIBERAL ARTS",2.2846,"G"
710,600,1310,"COMMUNICATIONS",3.4495,"G"
530,590,1120,"EDUCATION",3.5151,"G"
550,420,970,"NURSING",2.9444,"G"
520,680,1200,"NATURAL SCIENCE",2.6766,"G"
800,630,1430,"LIBERAL ARTS",4,"G"
440,510,950,"LIBERAL ARTS",3.1716,"G"
630,620,1250,"FINE ARTS",3.3303,"G"
660,560,1220,"LIBERAL ARTS",3.5769,"G"
680,700,1380,"LIBERAL ARTS",3.7024,"G"
620,630,1250,"BUSINESS",3.4594,"G"
490,610,1100,"LIBERAL ARTS",3.072,"G"
630,660,1290,"LIBERAL ARTS",3.5179,"G"
490,470,960,"LIBERAL ARTS",3.0964,"G"
590,570,1160,"NATURAL SCIENCE",2.8269,"G"
620,570,1190,"EDUCATION",3.7983,"G"
560,700,1260,"NURSING",3.0153,"G"
800,660,1460,"NATURAL SCIENCE",3.9385,"G"
660,700,1360,"NATURAL SCIENCE",3.7948,"G"
610,610,1220,"LIBERAL ARTS",3.53,"G"
700,620,1320,"LIBERAL ARTS",3.2115,"G"
650,680,1330,"NATURAL SCIENCE",3.2764,"G"
610,550,1160,"LIBERAL ARTS",2.9904,"G"
700,520,1220,"FINE ARTS",3.2689,"G"
510,460,970,"LIBERAL ARTS",3,"G"
590,660,1250,"NATURAL SCIENCE",3.2517,"G"
590,650,1240,"LIBERAL ARTS",2.5985,"G"
520,650,1170,"COMMUNICATIONS",3.891,"G"
600,720,1320,"NATURAL SCIENCE",3.4112,"G"
500,480,980,"COMMUNICATIONS",2.6724,"G"
720,740,1460,"COMMUNICATIONS",3.7794,"G"
340,550,890,"NURSING",3.1061,"G"
440,550,990,"LIBERAL ARTS",2.4713,"G"
580,610,1190,"NATURAL SCIENCE",2.9416,"G"
600,440,1040,"LIBERAL ARTS",3.024,"G"
610,670,1280,"NURSING",3.6439,"G"
680,600,1280,"COMMUNICATIONS",3.8666,"G"
660,710,1370,"LIBERAL ARTS",3.6142,"G"
700,750,1450,"ENGINEERING",3.707,"G"
440,490,930,"LIBERAL ARTS",2.5045,"G"
590,550,1140,"LIBERAL ARTS",2.236,"G"
670,750,1420,"ARCHITECTURE",3.9483,"G"
510,460,970,"COMMUNICATIONS",3.3648,"G"
800,710,1510,"ENGINEERING",3.8666,"G"
650,710,1360,"BUSINESS",3.5569,"G"
590,550,1140,"COMMUNICATIONS",2.6923,"G"
540,460,1000,"NATURAL SCIENCE",2.4482,"G"
470,470,940,"LIBERAL ARTS",3.2641,"G"
630,570,1200,"LIBERAL ARTS",3.67,"G"
600,510,1110,"BUSINESS",3.3636,"G"
530,520,1050,"LIBERAL ARTS",2.566,"G"
470,360,830,"COMMUNICATIONS",2.9278,"G"
610,610,1220,"ENGINEERING",3.4107,"G"
650,650,1300,"BUSINESS",2.757,"G"
550,650,1200,"ENGINEERING",3.3475,"G"
560,710,1270,"LIBERAL ARTS",2.8636,"G"
610,650,1260,"LIBERAL ARTS",3.6909,"G"
680,700,1380,"BUSINESS",3.7739,"G"
450,540,990,"NATURAL SCIENCE",2.5631,"G"
560,650,1210,"BUSINESS",2.9009,"G"
520,590,1110,"BUSINESS",3.8571,"G"
610,670,1280,"BUSINESS",3.0714,"G"
410,440,850,"LIBERAL ARTS",2.9262,"G"
690,600,1290,"COMMUNICATIONS",3.6691,"G"
760,670,1430,"BUSINESS",3.625,"G"
610,590,1200,"COMMUNICATIONS",2.9158,"G"
540,460,1000,"NATURAL SCIENCE",3.4878,"G"
560,590,1150,"LIBERAL ARTS",2.1864,"G"
560,520,1080,"LIBERAL ARTS",2.8829,"G"
560,630,1190,"LIBERAL ARTS",2.991,"G"
540,660,1200,"LIBERAL ARTS",2.9,"G"
570,510,1080,"LIBERAL ARTS",2.4045,"G"
590,680,1270,"NATURAL SCIENCE",3.6055,"G"
700,680,1380,"NATURAL SCIENCE",3.5035,"G"
580,660,1240,"NATURAL SCIENCE",2.2303,"G"
760,800,1560,"ENGINEERING",3.1094,"G"
690,720,1410,"LIBERAL ARTS",3.7586,"G"
560,630,1190,"ENGINEERING",2.5648,"G"
570,670,1240,"NATURAL SCIENCE",3.112,"G"
490,520,1010,"COMMUNICATIONS",3.9157,"G"
560,570,1130,"BUSINESS",3.6585,"G"
690,620,1310,"FINE ARTS",3.7214,"G"
610,490,1100,"NATURAL SCIENCE",2.6538,"G"
480,640,1120,"NATURAL SCIENCE",2.541,"G"
510,590,1100,"NATURAL SCIENCE",2.7619,"G"
630,560,1190,"LIBERAL ARTS",3.1592,"G"
800,700,1500,"LIBERAL ARTS",3.8015,"G"
540,530,1070,"ENGINEERING",3.21,"G"
460,420,880,"LIBERAL ARTS",2.4684,"G"
630,660,1290,"BUSINESS",2.8415,"G"
610,540,1150,"LIBERAL ARTS",3.7765,"G"
560,530,1090,"LIBERAL ARTS",2.8863,"G"
680,780,1460,"NATURAL SCIENCE",3.9655,"G"
650,540,1190,"NATURAL SCIENCE",3.1732,"G"
420,440,860,"COMMUNICATIONS",3.246,"G"
560,580,1140,"ENGINEERING",3.4656,"G"
580,750,1330,"ENGINEERING",3.1102,"G"
510,600,1110,"NATURAL SCIENCE",3.46,"G"
570,690,1260,"LIBERAL ARTS",3.1454,"G"
510,650,1160,"BUSINESS",3.3461,"G"
440,550,990,"NATURAL SCIENCE",3.2156,"G"
570,590,1160,"BUSINESS",3.5576,"G"
730,720,1450,"COMMUNICATIONS",3.6407,"G"
600,630,1230,"BUSINESS",3.3311,"G"
690,710,1400,"NATURAL SCIENCE",3.3741,"G"
620,580,1200,"NATURAL SCIENCE",2.9534,"G"
590,670,1260,"NATURAL SCIENCE",3.5793,"G"
680,800,1480,"NATURAL SCIENCE",3.2393,"G"
550,530,1080,"LIBERAL ARTS",3.3271,"G"
520,590,1110,"NATURAL SCIENCE",3.6339,"G"
580,700,1280,"NATURAL SCIENCE",3.0982,"G"
480,560,1040,"BUSINESS",2.2573,"G"
680,580,1260,"LIBERAL ARTS",3.0606,"G"
430,510,940,"LIBERAL ARTS",2.3015,"G"
590,630,1220,"LIBERAL ARTS",2.8412,"G"
610,680,1290,"BUSINESS",3.5785,"G"
700,660,1360,"LIBERAL ARTS",2.9417,"G"
620,640,1260,"LIBERAL ARTS",3.2031,"G"
590,660,1250,"NATURAL SCIENCE",2.672,"G"
660,660,1320,"NATURAL SCIENCE",3.685,"G"
430,500,930,"BUSINESS",3.0454,"G"
580,690,1270,"LIBERAL ARTS",3.9666,"G"
660,500,1160,"NURSING",3.9724,"G"
530,680,1210,"NATURAL SCIENCE",3,"G"
610,700,1310,"BUSINESS",3.37,"G"
620,550,1170,"LIBERAL ARTS",3.1838,"G"
610,550,1160,"LIBERAL ARTS",3.3464,"G"
670,660,1330,"ENGINEERING",3.7022,"G"
560,680,1240,"LIBERAL ARTS",3.625,"G"
630,740,1370,"BUSINESS",3.8736,"G"
440,480,920,"NATURAL SCIENCE",3.0353,"G"
690,570,1260,"COMMUNICATIONS",3.5677,"G"
590,630,1220,"LIBERAL ARTS",2.8865,"G"
570,650,1220,"LIBERAL ARTS",3.5425,"G"
500,710,1210,"ENGINEERING",3.1951,"G"
620,670,1290,"LIBERAL ARTS",3.5744,"G"
700,630,1330,"BUSINESS",3.6413,"G"
590,580,1170,"LIBERAL ARTS",2.5867,"G"
570,580,1150,"BUSINESS",2.6974,"G"
540,710,1250,"LIBERAL ARTS",3.8148,"G"
540,510,1050,"BUSINESS",3.1428,"G"
680,800,1480,"ENGINEERING",3.604,"G"
640,690,1330,"LIBERAL ARTS",3.5,"G"
740,640,1380,"BUSINESS",3.8972,"G"
510,550,1060,"LIBERAL ARTS",2.9268,"G"
600,740,1340,"ENGINEERING",2.435,"G"
520,610,1130,"BUSINESS",3.8571,"G"
520,600,1120,"NURSING",3.875,"G"
610,630,1240,"LIBERAL ARTS",3.3103,"G"
580,670,1250,"NATURAL SCIENCE",3.4942,"G"
620,700,1320,"ENGINEERING",3.0753,"G"
700,800,1500,"ENGINEERING",3.6814,"G"
580,710,1290,"ENGINEERING",2.6821,"G"
620,540,1160,"LIBERAL ARTS",2.2941,"G"
540,610,1150,"NATURAL SCIENCE",2.7222,"G"
660,700,1360,"BUSINESS",3.1089,"G"
550,600,1150,"COMMUNICATIONS",3.6464,"G"
540,670,1210,"LIBERAL ARTS",2.8349,"G"
480,540,1020,"NATURAL SCIENCE",3.38,"G"
570,630,1200,"LIBERAL ARTS",2.6956,"G"
740,580,1320,"LIBERAL ARTS",3.3697,"G"
630,720,1350,"NATURAL SCIENCE",2.1985,"G"
610,530,1140,"LIBERAL ARTS",2.7904,"G"
620,670,1290,"NATURAL SCIENCE",3.4452,"G"
650,670,1320,"LIBERAL ARTS",3.5032,"G"
700,700,1400,"BUSINESS",3.6,"G"
560,610,1170,"LIBERAL ARTS",3.1018,"G"
700,660,1360,"LIBERAL ARTS",3.1011,"G"
490,630,1120,"ENGINEERING",3.0769,"G"
560,520,1080,"LIBERAL ARTS",3.324,"G"
730,650,1380,"ENGINEERING",2.858,"G"
600,620,1220,"NATURAL SCIENCE",3.0467,"G"
540,620,1160,"NATURAL SCIENCE",3.4352,"G"
610,540,1150,"NATURAL SCIENCE",3.1603,"G"
590,430,1020,"LIBERAL ARTS",3.226,"G"
500,670,1170,"LIBERAL ARTS",3.5208,"G"
750,650,1400,"COMMUNICATIONS",3.1015,"G"
600,680,1280,"NATURAL SCIENCE",3.5161,"G"
570,540,1110,"BUSINESS",2.8053,"G"
630,630,1260,"NATURAL SCIENCE",2.9769,"G"
560,790,1350,"ENGINEERING",3.1304,"G"
630,630,1260,"LIBERAL ARTS",3.1791,"G"
480,620,1100,"ENGINEERING",2.0409,"G"
520,770,1290,"BUSINESS",3.4953,"G"
500,560,1060,"BUSINESS",2.4948,"G"
600,490,1090,"NATURAL SCIENCE",3.4778,"G"
620,640,1260,"BUSINESS",3.375,"G"
620,720,1340,"FINE ARTS",3.7608,"G"
470,470,940,"BUSINESS",2.1449,"G"
430,570,1000,"NATURAL SCIENCE",2.8796,"G"
630,690,1320,"BUSINESS",3.8108,"G"
580,570,1150,"LIBERAL ARTS",3.4842,"G"
540,580,1120,"LIBERAL ARTS",2.4926,"G"
570,650,1220,"NATURAL SCIENCE",3.8292,"G"
610,610,1220,"BUSINESS",3.9673,"G"
530,560,1090,"BUSINESS",2.785,"G"
430,480,910,"LIBERAL ARTS",2.32,"G"
580,540,1120,"NATURAL SCIENCE",3.8879,"G"
440,500,940,"ENGINEERING",2.5283,"G"
590,710,1300,"BUSINESS",3.307,"G"
670,650,1320,"ENGINEERING",3.0862,"G"
480,570,1050,"NATURAL SCIENCE",2.5423,"G"
640,660,1300,"BUSINESS",2.9807,"G"
530,500,1030,"LIBERAL ARTS",2.8636,"G"
570,490,1060,"LIBERAL ARTS",2.8582,"G"
430,610,1040,"LIBERAL ARTS",2.08,"G"
460,610,1070,"ENGINEERING",2.7672,"G"
520,520,1040,"EDUCATION",3.0923,"G"
570,640,1210,"LIBERAL ARTS",3.0377,"G"
510,660,1170,"LIBERAL ARTS",3.0444,"G"
610,630,1240,"LIBERAL ARTS",3.8217,"G"
560,750,1310,"ENGINEERING",3.7092,"G"
560,520,1080,"LIBERAL ARTS",3.0333,"G"
600,640,1240,"LIBERAL ARTS",3.3826,"G"
670,630,1300,"NATURAL SCIENCE",3.6888,"G"
560,620,1180,"BUSINESS",2.8256,"G"
650,650,1300,"ARCHITECTURE",3.7209,"G"
720,700,1420,"LIBERAL ARTS",3.8235,"G"
720,770,1490,"BUSINESS",3.8269,"G"
550,580,1130,"NATURAL SCIENCE",2.3495,"G"
610,580,1190,"LIBERAL ARTS",3.1282,"G"
560,430,990,"BUSINESS",2.2689,"G"
520,680,1200,"BUSINESS",3.909,"G"
570,650,1220,"NATURAL SCIENCE",3.6428,"G"
580,560,1140,"NATURAL SCIENCE",3.3644,"G"
520,620,1140,"LIBERAL ARTS",2.8992,"G"
460,530,990,"LIBERAL ARTS",2.1729,"G"
560,710,1270,"ENGINEERING",3.9538,"G"
560,590,1150,"BUSINESS",2.7578,"G"
520,610,1130,"COMMUNICATIONS",3.84,"G"
700,630,1330,"LIBERAL ARTS",2.8934,"G"
620,590,1210,"LIBERAL ARTS",3.8086,"G"
510,630,1140,"NATURAL SCIENCE",3.0873,"G"
690,740,1430,"BUSINESS",3.1896,"G"
640,650,1290,"NATURAL SCIENCE",3.5803,"G"
680,680,1360,"NATURAL SCIENCE",3.5619,"G"
640,700,1340,"BUSINESS",3.8064,"G"
640,720,1360,"COMMUNICATIONS",3.2325,"G"
520,490,1010,"BUSINESS",2.9809,"G"
680,620,1300,"LIBERAL ARTS",3.8155,"G"
570,520,1090,"LIBERAL ARTS",3.7476,"G"
640,630,1270,"COMMUNICATIONS",3.76,"G"
590,620,1210,"LIBERAL ARTS",2.6559,"G"
560,650,1210,"EDUCATION",3.423,"G"
530,560,1090,"BUSINESS",2.5194,"G"
630,570,1200,"NATURAL SCIENCE",2.6287,"G"
660,720,1380,"ENGINEERING",3.1467,"G"
610,790,1400,"LIBERAL ARTS",3.6043,"G"
710,660,1370,"BUSINESS",3.7631,"G"
750,680,1430,"ENGINEERING",3.3969,"G"
420,550,970,"LIBERAL ARTS",3.4736,"G"
640,790,1430,"LIBERAL ARTS",3.8913,"G"
660,600,1260,"NATURAL SCIENCE",3.909,"G"
570,630,1200,"LIBERAL ARTS",3.4747,"G"
660,530,1190,"LIBERAL ARTS",3.537,"G"
620,580,1200,"BUSINESS",2.8613,"G"
770,780,1550,"NATURAL SCIENCE",4,"G"
700,740,1440,"BUSINESS",3.592,"G"
600,690,1290,"LIBERAL ARTS",3.2886,"G"
700,560,1260,"FINE ARTS",3.2268,"G"
480,540,1020,"BUSINESS",3.3548,"G"
570,720,1290,"LIBERAL ARTS",2.6,"G"
480,550,1030,"NATURAL SCIENCE",2.5036,"G"
760,640,1400,"BUSINESS",3.6391,"G"
660,710,1370,"BUSINESS",4,"G"
580,630,1210,"NATURAL SCIENCE",2.5853,"G"
620,630,1250,"COMMUNICATIONS",3.6666,"G"
620,650,1270,"LIBERAL ARTS",3.2521,"G"
530,450,980,"BUSINESS",3.4,"G"
440,510,950,"LIBERAL ARTS",2.2283,"G"
650,660,1310,"NATURAL SCIENCE",2.5206,"G"
460,540,1000,"COMMUNICATIONS",2.9154,"G"
660,540,1200,"NURSING",3.304,"G"
410,410,820,"BUSINESS",2.729,"G"
530,610,1140,"BUSINESS",2.6666,"G"
600,610,1210,"LIBERAL ARTS",2.4529,"G"
600,550,1150,"BUSINESS",2.647,"G"
500,430,930,"NATURAL SCIENCE",2.2027,"G"
660,690,1350,"NATURAL SCIENCE",2.8728,"G"
530,490,1020,"LIBERAL ARTS",3.7029,"G"
510,520,1030,"ARCHITECTURE",3.31,"G"
640,620,1260,"LIBERAL ARTS",3.9752,"G"
610,600,1210,"NATURAL SCIENCE",2.6213,"G"
690,780,1470,"NATURAL SCIENCE",3.9274,"G"
670,520,1190,"LIBERAL ARTS",3.15,"G"
670,730,1400,"NATURAL SCIENCE",3.6644,"G"
600,630,1230,"NATURAL SCIENCE",3.1326,"G"
710,660,1370,"NATURAL SCIENCE",2.595,"G"
710,800,1510,"ENGINEERING",3.1964,"G"
700,650,1350,"LIBERAL ARTS",3.2986,"G"
610,580,1190,"LIBERAL ARTS",2.8349,"G"
690,720,1410,"ARCHITECTURE",3.4939,"G"
550,610,1160,"NATURAL SCIENCE",3.2385,"G"
650,610,1260,"NATURAL SCIENCE",3.1284,"G"
420,570,990,"SOCIAL WORK",3.5523,"G"
580,670,1250,"FINE ARTS",3.2258,"G"
530,630,1160,"ENGINEERING",2.2385,"G"
720,700,1420,"LIBERAL ARTS",3.9795,"G"
480,520,1000,"LIBERAL ARTS",3.4506,"G"
720,600,1320,"NATURAL SCIENCE",3.74,"G"
670,660,1330,"LIBERAL ARTS",2.6014,"G"
590,570,1160,"BUSINESS",3.4166,"G"
610,670,1280,"NATURAL SCIENCE",2.2649,"G"
580,610,1190,"LIBERAL ARTS",3.49,"G"
660,720,1380,"LIBERAL ARTS",3.4406,"G"
630,620,1250,"LIBERAL ARTS",3.2592,"G"
520,660,1180,"NATURAL SCIENCE",2.8775,"G"
580,700,1280,"ENGINEERING",2.4387,"G"
570,500,1070,"EDUCATION",3.1666,"G"
590,640,1230,"NATURAL SCIENCE",2.7606,"G"
580,490,1070,"LIBERAL ARTS",2.9322,"G"
670,690,1360,"BUSINESS",3.9083,"G"
510,630,1140,"EDUCATION",3.491,"G"
560,620,1180,"LIBERAL ARTS",3.2788,"G"
630,580,1210,"LIBERAL ARTS",2.8051,"G"
540,510,1050,"LIBERAL ARTS",3.4152,"G"
670,670,1340,"NATURAL SCIENCE",3.4901,"G"
600,630,1230,"LIBERAL ARTS",2.313,"G"
610,580,1190,"LIBERAL ARTS",3.4413,"G"
660,640,1300,"BUSINESS",3.9741,"G"
760,750,1510,"ENGINEERING",3.7439,"G"
510,530,1040,"LIBERAL ARTS",3.7053,"G"
620,660,1280,"NATURAL SCIENCE",3.5867,"G"
690,690,1380,"NATURAL SCIENCE",2.9459,"G"
600,610,1210,"NATURAL SCIENCE",2.728,"G"
630,570,1200,"LIBERAL ARTS",3.2452,"G"
790,690,1480,"COMMUNICATIONS",3.7669,"G"
700,580,1280,"NATURAL SCIENCE",3.5597,"G"
540,560,1100,"NATURAL SCIENCE",2.9021,"G"
640,630,1270,"NATURAL SCIENCE",3.5714,"G"
630,670,1300,"NATURAL SCIENCE",3.8211,"G"
670,600,1270,"NATURAL SCIENCE",3.6569,"G"
460,530,990,"NATURAL SCIENCE",2.3227,"G"
670,670,1340,"BUSINESS",3.548,"G"
680,560,1240,"LIBERAL ARTS",3.0659,"G"
580,570,1150,"NATURAL SCIENCE",3.2758,"G"
630,550,1180,"LIBERAL ARTS",2.8672,"G"
680,660,1340,"COMMUNICATIONS",3.431,"G"
570,610,1180,"FINE ARTS",3.8032,"G"
620,560,1180,"LIBERAL ARTS",3.103,"G"
410,550,960,"LIBERAL ARTS",3.1875,"G"
620,620,1240,"LIBERAL ARTS",2.2882,"G"
430,400,830,"BUSINESS",2.4205,"G"
550,620,1170,"LIBERAL ARTS",3.0176,"G"
630,780,1410,"ENGINEERING",3.0131,"G"
570,500,1070,"LIBERAL ARTS",2.9775,"G"
580,610,1190,"ENGINEERING",2.9557,"G"
530,520,1050,"NATURAL SCIENCE",3.3095,"G"
560,650,1210,"NATURAL SCIENCE",2.8583,"G"
600,710,1310,"BUSINESS",2.8312,"G"
560,500,1060,"NATURAL SCIENCE",2.5945,"G"
660,790,1450,"NATURAL SCIENCE",3.1764,"G"
680,680,1360,"LIBERAL ARTS",2.9821,"G"
750,680,1430,"ENGINEERING",3.2818,"G"
570,650,1220,"NATURAL SCIENCE",3.02,"G"
580,660,1240,"ENGINEERING",3.4818,"G"
470,550,1020,"NATURAL SCIENCE",3.4504,"G"
570,560,1130,"BUSINESS",2.5436,"G"
450,500,950,"EDUCATION",2.3114,"G"
530,630,1160,"BUSINESS",3.4336,"G"
610,640,1250,"NATURAL SCIENCE",3.3177,"G"
470,520,990,"LIBERAL ARTS",3.157,"G"
590,610,1200,"LIBERAL ARTS",2.0444,"G"
590,470,1060,"LIBERAL ARTS",3.2941,"G"
580,740,1320,"ENGINEERING",2.6621,"G"
470,530,1000,"LIBERAL ARTS",2.8015,"G"
780,660,1440,"LIBERAL ARTS",4,"G"
580,640,1220,"ENGINEERING",2.488,"G"
690,620,1310,"LIBERAL ARTS",2.5294,"G"
550,460,1010,"BUSINESS",3,"G"
800,720,1520,"LIBERAL ARTS",3.5555,"G"
520,570,1090,"BUSINESS",2.8373,"G"
570,510,1080,"LIBERAL ARTS",2.6293,"G"
540,470,1010,"BUSINESS",3.4766,"G"
580,470,1050,"COMMUNICATIONS",3.4239,"G"
650,760,1410,"NATURAL SCIENCE",3.0869,"G"
540,570,1110,"ENGINEERING",2.9624,"G"
770,730,1500,"ENGINEERING",2.916,"G"
650,690,1340,"BUSINESS",3.8548,"G"
650,630,1280,"NATURAL SCIENCE",2.1727,"G"
590,710,1300,"LIBERAL ARTS",3.6808,"G"
500,500,1000,"LIBERAL ARTS",3.244,"G"
540,470,1010,"NATURAL SCIENCE",2.6934,"G"
600,650,1250,"NATURAL SCIENCE",3.26,"G"
620,690,1310,"NATURAL SCIENCE",3.0808,"G"
720,700,1420,"LIBERAL ARTS",3.5588,"G"
690,680,1370,"ARCHITECTURE",3.7471,"G"
520,590,1110,"LIBERAL ARTS",2.7767,"G"
500,590,1090,"BUSINESS",3.2912,"G"
630,550,1180,"LIBERAL ARTS",2.3984,"G"
730,720,1450,"NATURAL SCIENCE",3.6562,"G"
550,580,1130,"FINE ARTS",2.9617,"G"
610,650,1260,"ENGINEERING",3.0091,"G"
570,560,1130,"NATURAL SCIENCE",3.2517,"G"
620,580,1200,"LIBERAL ARTS",3.4561,"G"
500,500,1000,"LIBERAL ARTS",2.2619,"G"
600,490,1090,"LIBERAL ARTS",2.3609,"G"
710,680,1390,"BUSINESS",3.5126,"G"
600,790,1390,"NATURAL SCIENCE",2.363,"G"
610,640,1250,"NATURAL SCIENCE",3.076,"G"
520,600,1120,"COMMUNICATIONS",2.8113,"G"
610,630,1240,"ENGINEERING",2.5428,"G"
610,670,1280,"BUSINESS",3.5849,"G"
660,580,1240,"LIBERAL ARTS",2.4504,"G"
570,540,1110,"LIBERAL ARTS",3.3629,"G"
770,590,1360,"LIBERAL ARTS",3.7105,"G"
470,560,1030,"LIBERAL ARTS",3.0654,"G"
400,440,840,"NATURAL SCIENCE",2.3553,"G"
640,520,1160,"LIBERAL ARTS",3.6883,"G"
800,700,1500,"BUSINESS",3.8853,"G"
800,660,1460,"NATURAL SCIENCE",3.7974,"G"
510,580,1090,"NATURAL SCIENCE",3.4452,"G"
640,660,1300,"LIBERAL ARTS",2.9912,"G"
480,460,940,"EDUCATION",3.2747,"G"
540,670,1210,"BUSINESS",2.6601,"G"
460,510,970,"BUSINESS",3.25,"G"
710,660,1370,"NATURAL SCIENCE",3.1363,"G"
660,500,1160,"LIBERAL ARTS",3.7473,"G"
620,800,1420,"BUSINESS",3.6742,"G"
630,560,1190,"ENGINEERING",2.2413,"G"
600,550,1150,"SOCIAL WORK",3.1833,"G"
680,650,1330,"COMMUNICATIONS",3.7717,"G"
540,550,1090,"NURSING",3.3604,"G"
580,710,1290,"COMMUNICATIONS",3.1652,"G"
400,500,900,"LIBERAL ARTS",2.0504,"G"
660,790,1450,"ENGINEERING",3.0508,"G"
560,620,1180,"BUSINESS",3.0582,"G"
550,630,1180,"NATURAL SCIENCE",2.5302,"G"
670,660,1330,"LIBERAL ARTS",3.0336,"G"
650,700,1350,"LIBERAL ARTS",2.119,"G"
690,660,1350,"NATURAL SCIENCE",3.0782,"G"
550,510,1060,"NATURAL SCIENCE",3.324,"G"
530,570,1100,"ENGINEERING",2.7031,"G"
530,530,1060,"LIBERAL ARTS",2.8104,"G"
590,760,1350,"ENGINEERING",2.9393,"G"
630,800,1430,"BUSINESS",3.9745,"G"
660,560,1220,"LIBERAL ARTS",3.4105,"G"
610,740,1350,"ENGINEERING",3.3389,"G"
560,600,1160,"NATURAL SCIENCE",3.2436,"G"
600,660,1260,"NATURAL SCIENCE",2.7073,"G"
470,630,1100,"NATURAL SCIENCE",2.3559,"G"
560,540,1100,"ENGINEERING",2.5725,"G"
720,680,1400,"COMMUNICATIONS",3.9634,"G"
680,730,1410,"ENGINEERING",2.4276,"G"
710,630,1340,"LIBERAL ARTS",3.1052,"G"
650,740,1390,"LIBERAL ARTS",3.9181,"G"
490,680,1170,"BUSINESS",3.0593,"G"
660,620,1280,"ENGINEERING",3.6722,"G"
650,740,1390,"NATURAL SCIENCE",3.9734,"G"
580,690,1270,"BUSINESS",3.1538,"G"
630,700,1330,"ENGINEERING",3.5689,"G"
560,520,1080,"LIBERAL ARTS",3.2022,"G"
620,590,1210,"NATURAL SCIENCE",2.1984,"G"
780,560,1340,"LIBERAL ARTS",3.1891,"G"
610,560,1170,"BUSINESS",3.1897,"G"
530,690,1220,"NATURAL SCIENCE",2.0773,"G"
530,560,1090,"NATURAL SCIENCE",3.0173,"G"
550,710,1260,"ENGINEERING",2.9787,"G"
600,590,1190,"LIBERAL ARTS",3.2965,"G"
530,590,1120,"ENGINEERING",3.2524,"G"
610,700,1310,"ENGINEERING",3.5156,"G"
420,510,930,"LIBERAL ARTS",2.2051,"G"
540,620,1160,"LIBERAL ARTS",3.5487,"G"
560,620,1180,"BUSINESS",3.4055,"G"
500,510,1010,"NATURAL SCIENCE",3.8167,"G"
470,630,1100,"LIBERAL ARTS",3.4803,"G"
590,640,1230,"LIBERAL ARTS",3.018,"G"
560,490,1050,"COMMUNICATIONS",2.6902,"G"
510,600,1110,"LIBERAL ARTS",2.264,"G"
630,690,1320,"BUSINESS",3.6562,"G"
730,740,1470,"LIBERAL ARTS",3.7086,"G"
600,570,1170,"LIBERAL ARTS",3.1333,"G"
480,620,1100,"COMMUNICATIONS",3.426,"G"
570,630,1200,"LIBERAL ARTS",2.9196,"G"
630,670,1300,"NATURAL SCIENCE",3.8333,"G"
720,630,1350,"BUSINESS",3.5816,"G"
650,670,1320,"LIBERAL ARTS",3.268,"G"
510,580,1090,"NATURAL SCIENCE",3.3565,"G"
710,680,1390,"NATURAL SCIENCE",3.554,"G"
530,480,1010,"LIBERAL ARTS",3,"G"
460,570,1030,"EDUCATION",2.646,"G"
600,470,1070,"ENGINEERING",2.4054,"G"
480,510,990,"LIBERAL ARTS",2.5925,"G"
530,600,1130,"ENGINEERING",3.0859,"G"
590,620,1210,"COMMUNICATIONS",3.2222,"G"
610,690,1300,"ENGINEERING",3.7391,"G"
660,650,1310,"BUSINESS",4,"G"
590,650,1240,"NATURAL SCIENCE",3.9727,"G"
570,560,1130,"COMMUNICATIONS",3.9259,"G"
420,590,1010,"ENGINEERING",2.5724,"G"
560,700,1260,"LIBERAL ARTS",3.741,"G"
470,630,1100,"ENGINEERING",2.5514,"G"
590,660,1250,"ENGINEERING",2.7596,"G"
630,800,1430,"NATURAL SCIENCE",3.2682,"G"
620,670,1290,"NATURAL SCIENCE",3.1916,"G"
560,650,1210,"NATURAL SCIENCE",3.5909,"G"
600,620,1220,"BUSINESS",3.2654,"G"
530,570,1100,"LIBERAL ARTS",2.6949,"G"
560,610,1170,"LIBERAL ARTS",3.5486,"G"
530,630,1160,"ENGINEERING",2.341,"G"
590,510,1100,"BUSINESS",3.8201,"G"
560,580,1140,"LIBERAL ARTS",3.2197,"G"
540,650,1190,"BUSINESS",4,"G"
640,650,1290,"ENGINEERING",3.1796,"G"
660,620,1280,"FINE ARTS",3.8434,"G"
510,600,1110,"LIBERAL ARTS",2.6396,"G"
700,600,1300,"BUSINESS",3.4758,"G"
610,650,1260,"BUSINESS",2.5773,"G"
660,600,1260,"LIBERAL ARTS",2.8148,"G"
540,560,1100,"LIBERAL ARTS",3.4017,"G"
680,730,1410,"ENGINEERING",3.902,"G"
700,590,1290,"LIBERAL ARTS",3.64,"G"
530,550,1080,"COMMUNICATIONS",3.372,"G"
560,580,1140,"LIBERAL ARTS",3.7569,"G"
680,740,1420,"NATURAL SCIENCE",3.3773,"G"
570,610,1180,"ENGINEERING",3.376,"G"
700,670,1370,"ENGINEERING",3.958,"G"
580,570,1150,"ENGINEERING",2.1176,"G"
620,660,1280,"FINE ARTS",3.5645,"G"
660,620,1280,"COMMUNICATIONS",3.6288,"G"
560,690,1250,"NATURAL SCIENCE",3.6528,"G"
700,540,1240,"LIBERAL ARTS",2.6071,"G"
580,590,1170,"LIBERAL ARTS",3.3113,"G"
600,670,1270,"LIBERAL ARTS",3.4017,"G"
600,700,1300,"ENGINEERING",3.7692,"G"
780,750,1530,"LIBERAL ARTS",3.4429,"G"
530,690,1220,"ENGINEERING",3.6355,"G"
650,770,1420,"ENGINEERING",3.9137,"G"
630,720,1350,"NATURAL SCIENCE",2.4545,"G"
670,720,1390,"LIBERAL ARTS",3.6805,"G"
580,640,1220,"LIBERAL ARTS",3.0727,"G"
550,650,1200,"BUSINESS",2.4464,"G"
790,800,1590,"LIBERAL ARTS",3.95,"G"
580,610,1190,"LIBERAL ARTS",3.3142,"G"
610,590,1200,"COMMUNICATIONS",3.7087,"G"
580,630,1210,"ENGINEERING",2.7449,"G"
560,570,1130,"NATURAL SCIENCE",3.422,"G"
780,740,1520,"LIBERAL ARTS",2.8344,"G"
710,670,1380,"LIBERAL ARTS",3.7714,"G"
540,520,1060,"FINE ARTS",3.7318,"G"
640,710,1350,"ENGINEERING",2.6578,"G"
530,520,1050,"LIBERAL ARTS",3.0697,"G"
540,560,1100,"NATURAL SCIENCE",3.4913,"G"
610,560,1170,"NATURAL SCIENCE",3.7933,"G"
690,670,1360,"LIBERAL ARTS",3.8586,"G"
520,490,1010,"BUSINESS",2.7589,"G"
560,540,1100,"LIBERAL ARTS",3.2962,"G"
610,590,1200,"NATURAL SCIENCE",2.5923,"G"
570,630,1200,"BUSINESS",3.8235,"G"
540,630,1170,"LIBERAL ARTS",3.2978,"G"
670,520,1190,"LIBERAL ARTS",3.8514,"G"
630,590,1220,"LIBERAL ARTS",3.124,"G"
780,650,1430,"COMMUNICATIONS",2.3185,"G"
550,660,1210,"LIBERAL ARTS",3.126,"G"
650,700,1350,"NATURAL SCIENCE",3.2894,"G"
630,770,1400,"NATURAL SCIENCE",3.7603,"G"
630,690,1320,"ENGINEERING",2.6093,"G"
640,560,1200,"NATURAL SCIENCE",2.8504,"G"
710,640,1350,"LIBERAL ARTS",3.9655,"G"
580,710,1290,"NATURAL SCIENCE",2.914,"G"
530,530,1060,"NATURAL SCIENCE",3.5045,"G"
500,580,1080,"LIBERAL ARTS",3.3663,"G"
710,770,1480,"ENGINEERING",2.9181,"G"
700,680,1380,"LIBERAL ARTS",2.7,"G"
600,580,1180,"NATURAL SCIENCE",3.1428,"G"
490,420,910,"LIBERAL ARTS",2.7398,"G"
590,560,1150,"COMMUNICATIONS",3.5274,"G"
670,560,1230,"LIBERAL ARTS",2.9365,"G"
700,710,1410,"NATURAL SCIENCE",2.546,"G"
560,460,1020,"LIBERAL ARTS",2.0894,"G"
640,710,1350,"ENGINEERING",3.7603,"G"
540,580,1120,"NATURAL SCIENCE",3.1666,"G"
610,580,1190,"BUSINESS",3.36,"G"
450,460,910,"LIBERAL ARTS",3.4492,"G"
710,790,1500,"NATURAL SCIENCE",3.8552,"G"
650,530,1180,"FINE ARTS",2.9174,"G"
510,560,1070,"BUSINESS",3.2168,"G"
560,500,1060,"LIBERAL ARTS",2.5714,"G"
660,540,1200,"LIBERAL ARTS",2.8558,"G"
700,730,1430,"BUSINESS",3.7226,"G"
660,690,1350,"FINE ARTS",3.2118,"G"
580,600,1180,"NATURAL SCIENCE",3.1755,"G"
630,600,1230,"FINE ARTS",3.1891,"G"
480,380,860,"EDUCATION",2.3703,"G"
430,490,920,"BUSINESS",2.6875,"G"
770,640,1410,"LIBERAL ARTS",3.1203,"G"
800,750,1550,"ARCHITECTURE",3.3017,"G"
640,540,1180,"LIBERAL ARTS",3.8,"G"
560,540,1100,"ENGINEERING",2.8632,"G"
470,610,1080,"NATURAL SCIENCE",3.051,"G"
640,710,1350,"NATURAL SCIENCE",3.0081,"G"
680,740,1420,"BUSINESS",3.2916,"G"
600,700,1300,"NATURAL SCIENCE",3.7983,"G"
640,700,1340,"ENGINEERING",3.9047,"G"
550,470,1020,"LIBERAL ARTS",3.13,"G"
690,650,1340,"ENGINEERING",3.75,"G"
520,560,1080,"NATURAL SCIENCE",2.4,"G"
460,560,1020,"ENGINEERING",2.6793,"G"
640,530,1170,"BUSINESS",3.5531,"G"
780,710,1490,"BUSINESS",3.7412,"G"
580,700,1280,"ENGINEERING",2.408,"G"
690,690,1380,"BUSINESS",3.8407,"G"
540,520,1060,"LIBERAL ARTS",2.3066,"G"
530,620,1150,"COMMUNICATIONS",3.3608,"G"
600,620,1220,"LIBERAL ARTS",3.5471,"G"
590,600,1190,"BUSINESS",2.7222,"G"
600,580,1180,"BUSINESS",3.0782,"G"
480,620,1100,"BUSINESS",2.7171,"G"
400,560,960,"BUSINESS",3.3684,"G"
520,650,1170,"NATURAL SCIENCE",3,"G"
520,510,1030,"LIBERAL ARTS",2.8598,"G"
460,590,1050,"LIBERAL ARTS",3.3551,"G"
590,610,1200,"BUSINESS",3.1401,"G"
680,600,1280,"BUSINESS",3.542,"G"
530,570,1100,"COMMUNICATIONS",3.1121,"G"
640,720,1360,"LIBERAL ARTS",3.3255,"G"
510,570,1080,"LIBERAL ARTS",2.5294,"G"
760,720,1480,"COMMUNICATIONS",3.8451,"G"
520,460,980,"COMMUNICATIONS",2.8,"G"
560,600,1160,"LIBERAL ARTS",3.1056,"G"
610,610,1220,"BUSINESS",2.7894,"G"
630,520,1150,"FINE ARTS",2.6634,"G"
460,540,1000,"LIBERAL ARTS",2.5206,"G"
510,640,1150,"EDUCATION",3.375,"G"
720,730,1450,"LIBERAL ARTS",3.969,"G"
530,650,1180,"BUSINESS",2.638,"G"
590,650,1240,"LIBERAL ARTS",2.7169,"G"
650,650,1300,"COMMUNICATIONS",3.3888,"G"
630,670,1300,"LIBERAL ARTS",3.3904,"G"
560,620,1180,"FINE ARTS",3.6013,"G"
510,560,1070,"ENGINEERING",2.8707,"G"
590,720,1310,"BUSINESS",3.5726,"G"
480,510,990,"BUSINESS",3.23,"G"
590,530,1120,"LIBERAL ARTS",3.3452,"G"
560,630,1190,"NATURAL SCIENCE",3.5943,"G"
560,660,1220,"BUSINESS",3.11,"G"
560,550,1110,"LIBERAL ARTS",2.7187,"G"
580,670,1250,"LIBERAL ARTS",2.2307,"G"
550,600,1150,"LIBERAL ARTS",3.3589,"G"
520,520,1040,"NATURAL SCIENCE",2.5922,"G"
640,550,1190,"LIBERAL ARTS",2.248,"G"
590,530,1120,"LIBERAL ARTS",3.807,"G"
640,580,1220,"BUSINESS",3.9801,"G"
590,670,1260,"BUSINESS",3.4827,"G"
440,580,1020,"NATURAL SCIENCE",3.132,"G"
760,720,1480,"BUSINESS",3.4324,"G"
620,650,1270,"ENGINEERING",3.5925,"G"
560,690,1250,"FINE ARTS",2.5877,"G"
650,610,1260,"ENGINEERING",2.7914,"G"
540,590,1130,"LIBERAL ARTS",2.8417,"G"
420,440,860,"LIBERAL ARTS",2.0467,"G"
620,750,1370,"NATURAL SCIENCE",3.3577,"G"
420,480,900,"NATURAL SCIENCE",3.0958,"G"
520,650,1170,"EDUCATION",3.469,"G"
630,640,1270,"LIBERAL ARTS",3.1875,"G"
660,670,1330,"ENGINEERING",3.168,"G"
550,580,1130,"COMMUNICATIONS",3.5539,"G"
660,750,1410,"BUSINESS",3.8309,"G"
760,700,1460,"LIBERAL ARTS",3.9243,"G"
640,650,1290,"LIBERAL ARTS",3.8208,"G"
570,650,1220,"ENGINEERING",3.2162,"G"
520,620,1140,"BUSINESS",3.4489,"G"
640,540,1180,"BUSINESS",2.7074,"G"
660,700,1360,"NATURAL SCIENCE",3.7076,"G"
630,620,1250,"BUSINESS",3.06,"G"
540,590,1130,"NATURAL SCIENCE",3.3846,"G"
480,600,1080,"ENGINEERING",2.1633,"G"
570,520,1090,"LIBERAL ARTS",3.1129,"G"
550,570,1120,"NURSING",2.8364,"G"
640,630,1270,"NATURAL SCIENCE",3.2844,"G"
670,630,1300,"FINE ARTS",2.5462,"G"
460,520,980,"LIBERAL ARTS",3.1496,"G"
520,710,1230,"BUSINESS",3.25,"G"
480,550,1030,"BUSINESS",2.9468,"G"
500,650,1150,"LIBERAL ARTS",2.3106,"G"
610,630,1240,"ENGINEERING",3,"G"
670,560,1230,"COMMUNICATIONS",2.8981,"G"
550,570,1120,"NATURAL SCIENCE",3.1651,"G"
590,790,1380,"NATURAL SCIENCE",2.6397,"G"
530,660,1190,"BUSINESS",3.4601,"G"
550,570,1120,"BUSINESS",3.2755,"G"
520,590,1110,"BUSINESS",3.287,"G"
530,570,1100,"NATURAL SCIENCE",2.9052,"G"
700,680,1380,"LIBERAL ARTS",2.4117,"G"
630,590,1220,"ENGINEERING",3.4409,"G"
630,580,1210,"COMMUNICATIONS",3.2,"G"
370,560,930,"ENGINEERING",2.7461,"G"
420,430,850,"COMMUNICATIONS",3.29,"G"
750,720,1470,"COMMUNICATIONS",4,"G"
550,560,1110,"BUSINESS",3.43,"G"
600,740,1340,"BUSINESS",2.4352,"G"
710,700,1410,"ENGINEERING",3.9024,"G"
610,580,1190,"NATURAL SCIENCE",3.242,"G"
620,710,1330,"ENGINEERING",3.7142,"G"
530,520,1050,"LIBERAL ARTS",2.8318,"G"
660,660,1320,"BUSINESS",3.7019,"G"
450,530,980,"BUSINESS",2.3402,"G"
540,560,1100,"NATURAL SCIENCE",2.9811,"G"
660,760,1420,"LIBERAL ARTS",3.5245,"G"
510,590,1100,"LIBERAL ARTS",3.312,"G"
660,710,1370,"LIBERAL ARTS",3.5853,"G"
590,590,1180,"BUSINESS",3.2321,"G"
640,690,1330,"BUSINESS",3.9478,"G"
520,680,1200,"BUSINESS",3.4789,"G"
500,480,980,"LIBERAL ARTS",2.5609,"G"
600,660,1260,"COMMUNICATIONS",3.4368,"G"
600,720,1320,"NATURAL SCIENCE",2.6234,"G"
620,760,1380,"BUSINESS",3.7789,"G"
650,710,1360,"ARCHITECTURE",3.6133,"G"
500,590,1090,"LIBERAL ARTS",3.6578,"G"
580,660,1240,"LIBERAL ARTS",3.0393,"G"
580,670,1250,"NATURAL SCIENCE",2.2932,"G"
700,740,1440,"LIBERAL ARTS",3.5964,"G"
590,720,1310,"ARCHITECTURE",3.45,"G"
470,550,1020,"BUSINESS",2.8644,"G"
510,580,1090,"LIBERAL ARTS",2.9843,"G"
540,580,1120,"LIBERAL ARTS",3.3071,"G"
510,500,1010,"BUSINESS",2.6862,"G"
610,620,1230,"EDUCATION",3.825,"G"
530,620,1150,"LIBERAL ARTS",2.3461,"G"
580,690,1270,"NATURAL SCIENCE",3.9662,"G"
510,510,1020,"LIBERAL ARTS",2.8532,"G"
660,650,1310,"NATURAL SCIENCE",3.3823,"G"
610,520,1130,"LIBERAL ARTS",3.0714,"G"
690,620,1310,"LIBERAL ARTS",3.9008,"G"
700,680,1380,"NATURAL SCIENCE",2.9756,"G"
580,600,1180,"BUSINESS",2.9444,"G"
630,680,1310,"EDUCATION",3.9354,"G"
520,510,1030,"EDUCATION",2.865,"G"
630,480,1110,"LIBERAL ARTS",2.8878,"G"
590,610,1200,"FINE ARTS",3.5054,"G"
580,540,1120,"NATURAL SCIENCE",2.1338,"G"
620,630,1250,"ENGINEERING",2.875,"G"
500,680,1180,"NATURAL SCIENCE",3.14,"G"
670,670,1340,"FINE ARTS",3.9,"G"
440,490,930,"ENGINEERING",3.0079,"G"
660,790,1450,"ENGINEERING",3.7109,"G"
580,560,1140,"LIBERAL ARTS",3.027,"G"
710,730,1440,"LIBERAL ARTS",3.8909,"G"
500,550,1050,"ENGINEERING",3.4242,"G"
680,650,1330,"LIBERAL ARTS",3.3157,"G"
670,790,1460,"BUSINESS",3.8016,"G"
690,710,1400,"LIBERAL ARTS",3.7058,"G"
570,580,1150,"LIBERAL ARTS",3.3669,"G"
670,610,1280,"LIBERAL ARTS",3.5172,"G"
480,550,1030,"NATURAL SCIENCE",2.7355,"G"
580,610,1190,"LIBERAL ARTS",3.0571,"G"
590,660,1250,"NATURAL SCIENCE",2.0261,"G"
490,530,1020,"LIBERAL ARTS",3.0569,"G"
530,610,1140,"ENGINEERING",3.25,"G"
660,660,1320,"NATURAL SCIENCE",2.9264,"G"
620,590,1210,"LIBERAL ARTS",3.31,"G"
630,550,1180,"COMMUNICATIONS",3.7,"G"
650,630,1280,"NATURAL SCIENCE",3.0353,"G"
560,640,1200,"ENGINEERING",3.4692,"G"
750,750,1500,"NATURAL SCIENCE",4,"G"
640,510,1150,"NATURAL SCIENCE",3.809,"G"
510,530,1040,"FINE ARTS",3.0454,"G"
570,510,1080,"COMMUNICATIONS",3.3333,"G"
610,580,1190,"NATURAL SCIENCE",3.1401,"G"
590,620,1210,"ENGINEERING",3.0145,"G"
510,530,1040,"BUSINESS",2.3229,"G"
590,670,1260,"LIBERAL ARTS",3.7668,"G"
470,380,850,"LIBERAL ARTS",2.9043,"G"
600,470,1070,"NATURAL SCIENCE",3.1192,"G"
500,560,1060,"LIBERAL ARTS",3.1404,"G"
570,620,1190,"ENGINEERING",3.3925,"G"
500,670,1170,"BUSINESS",3.0508,"G"
610,630,1240,"LIBERAL ARTS",2.9354,"G"
580,520,1100,"LIBERAL ARTS",3.0099,"G"
690,620,1310,"LIBERAL ARTS",3.8666,"G"
710,520,1230,"LIBERAL ARTS",3.8787,"G"
600,670,1270,"BUSINESS",3.6132,"G"
500,630,1130,"LIBERAL ARTS",3.7518,"G"
670,690,1360,"BUSINESS",3.2149,"G"
500,580,1080,"NATURAL SCIENCE",3.16,"G"
560,510,1070,"LIBERAL ARTS",2.5257,"G"
620,710,1330,"BUSINESS",3.2169,"G"
630,610,1240,"LIBERAL ARTS",3.0884,"G"
800,660,1460,"ENGINEERING",3.9268,"G"
560,570,1130,"LIBERAL ARTS",3.968,"G"
560,550,1110,"SOCIAL WORK",3.1157,"G"
540,620,1160,"BUSINESS",3.176,"G"
530,500,1030,"LIBERAL ARTS",2.4394,"G"
570,570,1140,"LIBERAL ARTS",3.7787,"G"
590,680,1270,"NATURAL SCIENCE",3.3565,"G"
600,580,1180,"SOCIAL WORK",3.4237,"G"
410,560,970,"EDUCATION",3.9142,"G"
600,490,1090,"NATURAL SCIENCE",3.4044,"G"
760,740,1500,"ENGINEERING",3.4433,"G"
550,580,1130,"BUSINESS",2.6637,"G"
480,480,960,"LIBERAL ARTS",2.9112,"G"
650,620,1270,"BUSINESS",3.4336,"G"
510,500,1010,"LIBERAL ARTS",2.5511,"G"
580,580,1160,"NATURAL SCIENCE",3.2627,"G"
710,650,1360,"LIBERAL ARTS",2.5877,"G"
590,720,1310,"BUSINESS",3.9782,"G"
560,590,1150,"NATURAL SCIENCE",3.5585,"G"
420,410,830,"BUSINESS",2.7207,"G"
680,770,1450,"NATURAL SCIENCE",2.8175,"G"
490,510,1000,"ENGINEERING",2.2647,"G"
590,640,1230,"NATURAL SCIENCE",3.6976,"G"
510,490,1000,"LIBERAL ARTS",3.1666,"G"
610,650,1260,"ENGINEERING",2.0061,"G"
630,680,1310,"BUSINESS",3.4042,"G"
700,580,1280,"ARCHITECTURE",2.9932,"G"
590,620,1210,"LIBERAL ARTS",3.5416,"G"
750,710,1460,"LIBERAL ARTS",3.8863,"G"
520,500,1020,"NATURAL SCIENCE",3.2366,"G"
590,800,1390,"ENGINEERING",3.3517,"G"
720,680,1400,"NATURAL SCIENCE",3.7794,"G"
510,660,1170,"BUSINESS",3.307,"G"
580,620,1200,"LIBERAL ARTS",3.7075,"G"
610,740,1350,"BUSINESS",3.7522,"G"
760,660,1420,"LIBERAL ARTS",3.1101,"G"
650,610,1260,"LIBERAL ARTS",3.4516,"G"
730,670,1400,"NATURAL SCIENCE",3.421,"G"
570,790,1360,"NATURAL SCIENCE",3.6326,"G"
560,580,1140,"EDUCATION",2.3153,"G"
620,650,1270,"ENGINEERING",3.1666,"G"
550,610,1160,"ENGINEERING",3.6428,"G"
480,530,1010,"LIBERAL ARTS",2.4313,"G"
600,660,1260,"ENGINEERING",3.8918,"G"
630,660,1290,"NATURAL SCIENCE",3.4056,"G"
570,490,1060,"LIBERAL ARTS",3.4,"G"
490,570,1060,"EDUCATION",2.92,"G"
500,550,1050,"NATURAL SCIENCE",2.9636,"G"
590,630,1220,"NATURAL SCIENCE",3.0747,"G"
630,700,1330,"ENGINEERING",3.0309,"G"
610,610,1220,"ENGINEERING",2.3495,"G"
560,650,1210,"FINE ARTS",2.7931,"G"
780,720,1500,"LIBERAL ARTS",3.975,"G"
640,800,1440,"NATURAL SCIENCE",4,"G"
690,530,1220,"FINE ARTS",3.1074,"G"
520,510,1030,"EDUCATION",2.5267,"G"
570,690,1260,"FINE ARTS",2.8437,"G"
620,700,1320,"BUSINESS",3.4488,"G"
590,710,1300,"ENGINEERING",3.9454,"G"
710,540,1250,"LIBERAL ARTS",3.787,"G"
650,710,1360,"BUSINESS",3.2898,"G"
540,510,1050,"COMMUNICATIONS",2.9158,"G"
600,610,1210,"LIBERAL ARTS",2.8794,"G"
540,560,1100,"LIBERAL ARTS",2.647,"G"
680,770,1450,"ENGINEERING",3.7914,"G"
630,770,1400,"BUSINESS",3.8016,"G"
690,710,1400,"ENGINEERING",3.5981,"G"
580,690,1270,"LIBERAL ARTS",2.9205,"G"
730,700,1430,"NATURAL SCIENCE",3.2709,"G"
460,520,980,"LIBERAL ARTS",2.6461,"G"
800,790,1590,"LIBERAL ARTS",3.8604,"G"
670,630,1300,"ENGINEERING",3.2335,"G"
570,680,1250,"LIBERAL ARTS",2.625,"G"
570,620,1190,"BUSINESS",3.1632,"G"
640,710,1350,"NATURAL SCIENCE",3.7523,"G"
610,530,1140,"COMMUNICATIONS",3.271,"G"
500,560,1060,"LIBERAL ARTS",2.2277,"G"
670,580,1250,"LIBERAL ARTS",3.2368,"G"
540,690,1230,"NATURAL SCIENCE",2.623,"G"
540,550,1090,"ENGINEERING",2.328,"G"
700,710,1410,"ENGINEERING",3.9797,"G"
710,640,1350,"LIBERAL ARTS",3.8543,"G"
530,600,1130,"ENGINEERING",3.2905,"G"
500,620,1120,"LIBERAL ARTS",3.37,"G"
540,630,1170,"BUSINESS",3.3284,"G"
600,630,1230,"NATURAL SCIENCE",2.7473,"G"
630,650,1280,"LIBERAL ARTS",2.8897,"G"
530,660,1190,"LIBERAL ARTS",2.3602,"G"
760,800,1560,"ENGINEERING",3.006,"G"
530,620,1150,"NATURAL SCIENCE",2.659,"G"
550,640,1190,"NATURAL SCIENCE",3.2568,"G"
610,610,1220,"COMMUNICATIONS",3.3404,"G"
680,640,1320,"SOCIAL WORK",2.736,"G"
730,650,1380,"NATURAL SCIENCE",3.9752,"G"
750,740,1490,"LIBERAL ARTS",3.9705,"G"
730,660,1390,"NATURAL SCIENCE",3.0089,"G"
490,510,1000,"BUSINESS",3.1938,"G"
600,600,1200,"COMMUNICATIONS",3.5315,"G"
580,550,1130,"LIBERAL ARTS",3.2521,"G"
560,650,1210,"LIBERAL ARTS",3.1138,"G"
670,690,1360,"BUSINESS",3.5365,"G"
510,660,1170,"LIBERAL ARTS",3.134,"G"
540,570,1110,"LIBERAL ARTS",2.307,"G"
540,550,1090,"LIBERAL ARTS",2.7968,"G"
610,650,1260,"LIBERAL ARTS",2.229,"G"
520,530,1050,"NATURAL SCIENCE",3.4226,"G"
530,540,1070,"NATURAL SCIENCE",3.8157,"G"
480,540,1020,"NATURAL SCIENCE",3.4262,"G"
540,530,1070,"NURSING",2.11,"G"
570,550,1120,"ENGINEERING",2.5104,"G"
670,690,1360,"LIBERAL ARTS",3.567,"G"
520,530,1050,"LIBERAL ARTS",2.7883,"G"
590,590,1180,"BUSINESS",3.5179,"G"
540,640,1180,"NATURAL SCIENCE",3.1851,"G"
640,620,1260,"NATURAL SCIENCE",3.072,"G"
640,660,1300,"BUSINESS",2.8448,"G"
560,630,1190,"LIBERAL ARTS",2.2543,"G"
570,650,1220,"NATURAL SCIENCE",2.8476,"G"
530,520,1050,"LIBERAL ARTS",2.7142,"G"
560,540,1100,"LIBERAL ARTS",3.7297,"G"
580,580,1160,"BUSINESS",3.7924,"G"
560,770,1330,"NATURAL SCIENCE",3.7414,"G"
600,580,1180,"LIBERAL ARTS",2.439,"G"
620,700,1320,"ENGINEERING",3.9818,"G"
510,520,1030,"LIBERAL ARTS",2.3937,"G"
640,580,1220,"COMMUNICATIONS",3.2924,"G"
530,550,1080,"EDUCATION",3.0461,"G"
670,710,1380,"ENGINEERING",3.8881,"G"
480,590,1070,"LIBERAL ARTS",3.3608,"G"
680,630,1310,"LIBERAL ARTS",3.1565,"G"
600,620,1220,"NATURAL SCIENCE",3.3833,"G"
560,690,1250,"BUSINESS",3.5263,"G"
520,650,1170,"LIBERAL ARTS",3.064,"G"
610,710,1320,"BUSINESS",3.6382,"G"
480,580,1060,"LIBERAL ARTS",3.018,"G"
490,540,1030,"BUSINESS",3.0254,"G"
510,580,1090,"FINE ARTS",3.0521,"G"
560,520,1080,"COMMUNICATIONS",3.6022,"G"
620,720,1340,"BUSINESS",3.9724,"G"
480,450,930,"ENGINEERING",2.2165,"G"
610,690,1300,"LIBERAL ARTS",2.6062,"G"
580,670,1250,"BUSINESS",3.4491,"G"
500,590,1090,"LIBERAL ARTS",2.4454,"G"
580,590,1170,"ENGINEERING",3.0212,"G"
430,490,920,"ENGINEERING",3.3904,"G"
550,550,1100,"NATURAL SCIENCE",2.5132,"G"
580,690,1270,"ENGINEERING",3.11,"G"
440,510,950,"LIBERAL ARTS",2.8137,"G"
650,650,1300,"LIBERAL ARTS",2.8515,"G"
530,490,1020,"COMMUNICATIONS",3.9,"G"
770,550,1320,"LIBERAL ARTS",3.4528,"G"
690,620,1310,"LIBERAL ARTS",3.8267,"G"
730,670,1400,"NATURAL SCIENCE",3.6277,"G"
640,670,1310,"COMMUNICATIONS",4,"G"
540,560,1100,"BUSINESS",3.9158,"G"
710,750,1460,"LIBERAL ARTS",3.1094,"G"
500,540,1040,"FINE ARTS",3.3913,"G"
660,600,1260,"FINE ARTS",3.5966,"G"
650,640,1290,"LIBERAL ARTS",3.8854,"G"
580,610,1190,"NATURAL SCIENCE",2.9915,"G"
540,490,1030,"EDUCATION",3.2127,"G"
530,500,1030,"BUSINESS",1.9431,"G"
540,490,1030,"EDUCATION",3.0081,"G"
560,500,1060,"BUSINESS",3.0727,"G"
580,660,1240,"NATURAL SCIENCE",2.7681,"G"
530,580,1110,"FINE ARTS",2.3867,"G"
570,530,1100,"EDUCATION",2.5338,"G"
620,590,1210,"ENGINEERING",2.4621,"G"
670,620,1290,"BUSINESS",4,"G"
590,470,1060,"LIBERAL ARTS",2.8813,"G"
610,630,1240,"BUSINESS",3,"G"
590,630,1220,"NATURAL SCIENCE",3.8131,"G"
460,510,970,"BUSINESS",3.1375,"G"
600,560,1160,"LIBERAL ARTS",3.5327,"G"
630,650,1280,"LIBERAL ARTS",2.708,"G"
650,690,1340,"LIBERAL ARTS",3.3076,"G"
520,590,1110,"LIBERAL ARTS",1.838,"G"
630,560,1190,"LIBERAL ARTS",3.0937,"G"
420,470,890,"BUSINESS",2.1798,"G"
590,690,1280,"LIBERAL ARTS",3.6557,"G"
720,540,1260,"FINE ARTS",2.8584,"G"
710,630,1340,"LIBERAL ARTS",3.723,"G"
630,630,1260,"LIBERAL ARTS",3.5514,"G"
450,490,940,"NURSING",3.2666,"G"
590,620,1210,"EDUCATION",3.0727,"G"
500,540,1040,"LIBERAL ARTS",3.5193,"G"
590,610,1200,"LIBERAL ARTS",2.3966,"G"
650,700,1350,"NATURAL SCIENCE",3.1517,"G"
530,630,1160,"LIBERAL ARTS",3.2276,"G"
600,620,1220,"BUSINESS",3.2814,"G"
510,570,1080,"LIBERAL ARTS",3.0291,"G"
590,670,1260,"EDUCATION",2.8411,"G"
660,500,1160,"LIBERAL ARTS",3.1261,"G"
670,710,1380,"LIBERAL ARTS",3.851,"G"
480,490,970,"LIBERAL ARTS",2.784,"G"
690,600,1290,"LIBERAL ARTS",3.8125,"G"
560,620,1180,"LIBERAL ARTS",2.0684,"G"
660,710,1370,"COMMUNICATIONS",3.602,"G"
560,610,1170,"FINE ARTS",3.2184,"G"
540,470,1010,"LIBERAL ARTS",2.5049,"G"
510,550,1060,"BUSINESS",3.3076,"G"
660,560,1220,"LIBERAL ARTS",3.3773,"G"
540,600,1140,"LIBERAL ARTS",2,"G"
560,540,1100,"NATURAL SCIENCE",2.8208,"G"
630,650,1280,"NATURAL SCIENCE",2.2266,"G"
790,750,1540,"LIBERAL ARTS",3.961,"G"
550,680,1230,"BUSINESS",3.5079,"G"
560,570,1130,"EDUCATION",3.3461,"G"
630,530,1160,"LIBERAL ARTS",3.5638,"G"
680,790,1470,"ENGINEERING",3.0757,"G"
630,790,1420,"ENGINEERING",3.1287,"G"
620,570,1190,"NATURAL SCIENCE",3.0265,"G"
450,580,1030,"EDUCATION",3.2359,"G"
610,590,1200,"NATURAL SCIENCE",2.9059,"G"
560,580,1140,"LIBERAL ARTS",3.1626,"G"
520,630,1150,"BUSINESS",3.0267,"G"
510,530,1040,"EDUCATION",2.625,"G"
550,690,1240,"ENGINEERING",3.4056,"G"
640,630,1270,"BUSINESS",3.4433,"G"
490,650,1140,"BUSINESS",3.1267,"G"
500,550,1050,"EDUCATION",3.56,"G"
520,580,1100,"FINE ARTS",3.3974,"G"
620,610,1230,"NATURAL SCIENCE",4,"G"
520,540,1060,"NATURAL SCIENCE",3.2947,"G"
440,570,1010,"COMMUNICATIONS",2.616,"G"
660,630,1290,"ENGINEERING",2.9496,"G"
560,680,1240,"NATURAL SCIENCE",3.4956,"G"
520,550,1070,"EDUCATION",2.9537,"G"
610,580,1190,"LIBERAL ARTS",3.3063,"G"
590,590,1180,"LIBERAL ARTS",3.4313,"G"
740,630,1370,"COMMUNICATIONS",3.4473,"G"
660,630,1290,"NATURAL SCIENCE",3.9126,"G"
720,790,1510,"LIBERAL ARTS",3.9136,"G"
760,760,1520,"NATURAL SCIENCE",3.5496,"G"
530,660,1190,"NURSING",3.4,"G"
600,570,1170,"NATURAL SCIENCE",2.9424,"G"
640,570,1210,"NATURAL SCIENCE",3.9777,"G"
720,650,1370,"LIBERAL ARTS",4,"G"
670,770,1440,"NATURAL SCIENCE",3.509,"G"
560,560,1120,"LIBERAL ARTS",2.875,"G"
620,590,1210,"LIBERAL ARTS",3.5158,"G"
470,520,990,"NATURAL SCIENCE",3.2329,"G"
730,600,1330,"LIBERAL ARTS",3.0482,"G"
620,540,1160,"NURSING",4,"G"
630,740,1370,"NATURAL SCIENCE",3.8991,"G"
540,590,1130,"NATURAL SCIENCE",2.55,"G"
690,690,1380,"BUSINESS",3.5648,"G"
460,610,1070,"ENGINEERING",2.414,"G"
570,790,1360,"ENGINEERING",2.975,"G"
730,710,1440,"ENGINEERING",3.0677,"G"
560,500,1060,"LIBERAL ARTS",3.5816,"G"
610,690,1300,"BUSINESS",3.536,"G"
770,740,1510,"BUSINESS",3.9154,"G"
670,610,1280,"NATURAL SCIENCE",2.2898,"G"
800,610,1410,"LIBERAL ARTS",4,"G"
610,660,1270,"NURSING",3.0084,"G"
650,660,1310,"BUSINESS",2.932,"G"
600,660,1260,"LIBERAL ARTS",2.7456,"G"
610,620,1230,"LIBERAL ARTS",3.75,"G"
660,670,1330,"COMMUNICATIONS",3.9181,"G"
640,660,1300,"ENGINEERING",2.0763,"G"
530,590,1120,"BUSINESS",1.9072,"G"
610,660,1270,"BUSINESS",3.6597,"G"
590,740,1330,"NATURAL SCIENCE",2.0337,"G"
590,640,1230,"NATURAL SCIENCE",3.4033,"G"
720,600,1320,"NATURAL SCIENCE",3.6782,"G"
520,470,990,"LIBERAL ARTS",3.3238,"G"
660,580,1240,"BUSINESS",2.6571,"G"
640,710,1350,"ENGINEERING",3.4262,"G"
650,690,1340,"BUSINESS",4,"G"
590,560,1150,"NATURAL SCIENCE",2.7092,"G"
530,630,1160,"LIBERAL ARTS",2.1007,"G"
530,610,1140,"BUSINESS",2.6914,"G"
640,520,1160,"COMMUNICATIONS",3.9693,"G"
710,790,1500,"ENGINEERING",3.8698,"G"
540,520,1060,"COMMUNICATIONS",3.84,"G"
480,530,1010,"LIBERAL ARTS",3.094,"G"
550,580,1130,"LIBERAL ARTS",3.5338,"G"
670,610,1280,"LIBERAL ARTS",3.3684,"G"
580,590,1170,"BUSINESS",3,"G"
540,600,1140,"FINE ARTS",2.8372,"G"
530,580,1110,"ENGINEERING",3.3333,"G"
470,600,1070,"LIBERAL ARTS",2.6666,"G"
690,500,1190,"COMMUNICATIONS",3.4545,"G"
650,580,1230,"LIBERAL ARTS",2.4789,"G"
480,660,1140,"ENGINEERING",3.2463,"G"
720,680,1400,"ARCHITECTURE",3.0619,"G"
610,660,1270,"LIBERAL ARTS",1.9379,"G"
530,620,1150,"BUSINESS",3.2796,"G"
670,650,1320,"NATURAL SCIENCE",3.5193,"G"
580,510,1090,"BUSINESS",2.5307,"G"
630,650,1280,"EDUCATION",3.6907,"G"
550,520,1070,"BUSINESS",3.5585,"G"
550,680,1230,"LIBERAL ARTS",2.5128,"G"
550,600,1150,"ENGINEERING",3.5344,"G"
560,590,1150,"BUSINESS",3.1386,"G"
540,580,1120,"EDUCATION",3.1296,"G"
660,620,1280,"BUSINESS",3.1057,"G"
670,730,1400,"BUSINESS",3.5086,"G"
650,590,1240,"LIBERAL ARTS",2.9379,"G"
480,520,1000,"ENGINEERING",3.0075,"G"
730,750,1480,"BUSINESS",4,"G"
690,620,1310,"LIBERAL ARTS",2.6518,"G"
570,550,1120,"LIBERAL ARTS",3.5964,"G"
740,630,1370,"ENGINEERING",2.9191,"G"
520,600,1120,"SOCIAL WORK",3.5161,"G"
510,490,1000,"COMMUNICATIONS",3.3298,"G"
450,560,1010,"LIBERAL ARTS",2.7071,"G"
520,670,1190,"LIBERAL ARTS",2.4464,"G"
620,600,1220,"COMMUNICATIONS",3.8739,"G"
630,690,1320,"ENGINEERING",3.7024,"G"
530,540,1070,"COMMUNICATIONS",3.5161,"G"
670,590,1260,"LIBERAL ARTS",2.625,"G"
530,550,1080,"LIBERAL ARTS",3.4299,"G"
720,640,1360,"LIBERAL ARTS",3.4871,"G"
800,770,1570,"BUSINESS",3.5203,"G"
640,740,1380,"LIBERAL ARTS",3.4899,"G"
650,530,1180,"LIBERAL ARTS",3.5252,"G"
630,650,1280,"LIBERAL ARTS",2.8061,"G"
380,460,840,"ENGINEERING",2.0924,"G"
580,560,1140,"EDUCATION",3.0449,"G"
700,570,1270,"LIBERAL ARTS",3.3125,"G"
660,630,1290,"NATURAL SCIENCE",3.7204,"G"
520,530,1050,"LIBERAL ARTS",2.547,"G"
660,630,1290,"COMMUNICATIONS",3.7391,"G"
660,600,1260,"NATURAL SCIENCE",3.699,"G"
640,650,1290,"BUSINESS",3.5229,"G"
680,740,1420,"LIBERAL ARTS",3.5428,"G"
530,590,1120,"NATURAL SCIENCE",2.1654,"G"
720,540,1260,"LIBERAL ARTS",2.2193,"G"
480,570,1050,"LIBERAL ARTS",2.959,"G"
630,730,1360,"NATURAL SCIENCE",3.3894,"G"
620,670,1290,"NATURAL SCIENCE",3.9517,"G"
540,510,1050,"BUSINESS",1.9927,"G"
560,670,1230,"LIBERAL ARTS",3.5478,"G"
530,650,1180,"NATURAL SCIENCE",3.2782,"G"
650,580,1230,"ENGINEERING",2.7678,"G"
520,560,1080,"COMMUNICATIONS",3.713,"G"
590,660,1250,"COMMUNICATIONS",2.7388,"G"
530,620,1150,"LIBERAL ARTS",3.1388,"G"
400,340,740,"NATURAL SCIENCE",2.8285,"G"
650,730,1380,"NATURAL SCIENCE",1.9756,"G"
440,530,970,"NATURAL SCIENCE",2.4871,"G"
590,640,1230,"LIBERAL ARTS",4,"G"
540,600,1140,"LIBERAL ARTS",3.0604,"G"
660,770,1430,"ENGINEERING",3.8482,"G"
480,530,1010,"LIBERAL ARTS",2.0901,"G"
730,670,1400,"COMMUNICATIONS",3.2248,"G"
530,690,1220,"BUSINESS",3.7027,"G"
650,770,1420,"ENGINEERING",3.1839,"G"
540,590,1130,"ENGINEERING",2.6146,"G"
590,700,1290,"ENGINEERING",3.4521,"G"
570,650,1220,"BUSINESS",3.592,"G"
660,570,1230,"NATURAL SCIENCE",3.5882,"G"
630,710,1340,"ENGINEERING",2.9776,"G"
500,660,1160,"BUSINESS",3.3362,"G"
590,710,1300,"BUSINESS",3.2631,"G"
700,600,1300,"COMMUNICATIONS",3.6666,"G"
550,610,1160,"NATURAL SCIENCE",3.4326,"G"
600,540,1140,"NATURAL SCIENCE",4,"G"
640,800,1440,"ENGINEERING",3.0592,"G"
640,690,1330,"BUSINESS",2.9479,"G"
490,630,1120,"LIBERAL ARTS",3.5684,"G"
630,680,1310,"LIBERAL ARTS",3.9142,"G"
500,530,1030,"LIBERAL ARTS",3.0373,"G"
710,690,1400,"LIBERAL ARTS",3.5,"G"
580,670,1250,"COMMUNICATIONS",3.809,"G"
620,710,1330,"ENGINEERING",3.5312,"G"
610,670,1280,"NATURAL SCIENCE",2.609,"G"
520,560,1080,"NATURAL SCIENCE",2.9817,"G"
680,660,1340,"ENGINEERING",3.1287,"G"
440,550,990,"LIBERAL ARTS",3.4214,"G"
550,550,1100,"FINE ARTS",2.2483,"G"
630,740,1370,"NATURAL SCIENCE",3.681,"G"
650,620,1270,"LIBERAL ARTS",3.9142,"G"
540,580,1120,"NATURAL SCIENCE",3.2941,"G"
640,630,1270,"LIBERAL ARTS",2.6333,"G"
750,750,1500,"ENGINEERING",2.9322,"G"
720,800,1520,"BUSINESS",3.8608,"G"
580,790,1370,"ENGINEERING",3.3142,"G"
760,700,1460,"NATURAL SCIENCE",3.5865,"G"
540,610,1150,"BUSINESS",3.57,"G"
530,620,1150,"NATURAL SCIENCE",3.4687,"G"
700,770,1470,"BUSINESS",3.855,"G"
530,520,1050,"NATURAL SCIENCE",3.9069,"G"
590,720,1310,"LIBERAL ARTS",3.3589,"G"
560,530,1090,"LIBERAL ARTS",2.7368,"G"
640,700,1340,"ENGINEERING",3.5585,"G"
730,790,1520,"BUSINESS",3.8108,"G"
610,690,1300,"LIBERAL ARTS",3.3627,"G"
560,560,1120,"NATURAL SCIENCE",2.5675,"G"
700,690,1390,"BUSINESS",2.9512,"G"
620,590,1210,"LIBERAL ARTS",3.0312,"G"
610,610,1220,"LIBERAL ARTS",3.2166,"G"
520,560,1080,"LIBERAL ARTS",2.8243,"G"
750,750,1500,"NATURAL SCIENCE",3.7795,"G"
620,540,1160,"COMMUNICATIONS",3.7666,"G"
660,680,1340,"ENGINEERING",3.7258,"G"
660,630,1290,"BUSINESS",3.5981,"G"
630,610,1240,"BUSINESS",3.7469,"G"
620,590,1210,"ENGINEERING",3.2857,"G"
670,770,1440,"ENGINEERING",3.623,"G"
640,650,1290,"BUSINESS",3.5229,"G"
540,680,1220,"LIBERAL ARTS",3.2647,"G"
650,660,1310,"NATURAL SCIENCE",3.7421,"G"
580,560,1140,"LIBERAL ARTS",3.126,"G"
450,560,1010,"LIBERAL ARTS",3.6666,"G"
630,640,1270,"LIBERAL ARTS",3.4222,"G"
600,660,1260,"ENGINEERING",2.9508,"G"
530,670,1200,"LIBERAL ARTS",3.1111,"G"
680,670,1350,"LIBERAL ARTS",3.6159,"G"
630,700,1330,"NATURAL SCIENCE",2.7007,"G"
600,710,1310,"ENGINEERING",3.6446,"G"
590,490,1080,"LIBERAL ARTS",3.7153,"G"
570,620,1190,"NATURAL SCIENCE",3.8984,"G"
700,800,1500,"ENGINEERING",3.5359,"G"
600,640,1240,"LIBERAL ARTS",3.3617,"G"
540,650,1190,"NATURAL SCIENCE",2.2671,"G"
580,600,1180,"BUSINESS",3.4324,"G"
500,580,1080,"COMMUNICATIONS",3.1521,"G"
730,670,1400,"ENGINEERING",3.2241,"G"
660,550,1210,"BUSINESS",3.7815,"G"
800,730,1530,"LIBERAL ARTS",3.5462,"G"
670,630,1300,"ARCHITECTURE",3.696,"G"
650,760,1410,"ENGINEERING",3.877,"G"
590,590,1180,"LIBERAL ARTS",3.4222,"G"
630,600,1230,"BUSINESS",3.2605,"G"
590,610,1200,"LIBERAL ARTS",3.2035,"G"
550,550,1100,"LIBERAL ARTS",3.7428,"G"
560,580,1140,"ENGINEERING",2.581,"G"
370,460,830,"NATURAL SCIENCE",2.5076,"G"
640,630,1270,"ENGINEERING",3.4457,"G"
560,470,1030,"LIBERAL ARTS",3.3166,"G"
580,610,1190,"LIBERAL ARTS",2.3714,"G"
530,570,1100,"LIBERAL ARTS",2.9642,"G"
590,640,1230,"LIBERAL ARTS",2.9538,"G"
670,620,1290,"NURSING",3.6173,"G"
510,650,1160,"ENGINEERING",3.0769,"G"
450,580,1030,"BUSINESS",3.3333,"G"
660,650,1310,"BUSINESS",3.5242,"G"
450,610,1060,"ENGINEERING",3.2043,"G"
600,560,1160,"LIBERAL ARTS",2.9576,"G"
490,510,1000,"BUSINESS",2.7368,"G"
620,560,1180,"EDUCATION",3.7142,"G"
620,580,1200,"LIBERAL ARTS",3.5254,"G"
600,720,1320,"ENGINEERING",3.0729,"G"
690,710,1400,"BUSINESS",3.317,"G"
500,660,1160,"NATURAL SCIENCE",3.7,"G"
630,580,1210,"NATURAL SCIENCE",3.6608,"G"
550,640,1190,"NATURAL SCIENCE",3.5775,"G"
690,680,1370,"FINE ARTS",3.813,"G"
560,580,1140,"NURSING",3.9747,"G"
590,660,1250,"BUSINESS",3.3473,"G"
690,700,1390,"ENGINEERING",3.5151,"G"
620,530,1150,"COMMUNICATIONS",3.2735,"G"
640,420,1060,"NATURAL SCIENCE",3.3,"G"
610,740,1350,"NATURAL SCIENCE",2.9016,"G"
590,620,1210,"BUSINESS",3.1652,"G"
640,530,1170,"LIBERAL ARTS",3.4049,"G"
650,620,1270,"NATURAL SCIENCE",3.4218,"G"
600,610,1210,"LIBERAL ARTS",3.2873,"G"
670,630,1300,"ENGINEERING",2.8482,"G"
570,550,1120,"LIBERAL ARTS",3.0091,"G"
640,690,1330,"COMMUNICATIONS",3.923,"G"
600,490,1090,"COMMUNICATIONS",2.7841,"G"
560,650,1210,"BUSINESS",3.3736,"G"
600,600,1200,"LIBERAL ARTS",2.7737,"G"
680,700,1380,"LIBERAL ARTS",2.8288,"G"
600,660,1260,"BUSINESS",3.6869,"G"
600,720,1320,"ENGINEERING",3.409,"G"
530,590,1120,"NATURAL SCIENCE",2.4605,"G"
640,670,1310,"NATURAL SCIENCE",2.7878,"G"
620,540,1160,"LIBERAL ARTS",3.5365,"G"
630,520,1150,"BUSINESS",2.8846,"G"
450,570,1020,"ENGINEERING",3.3611,"G"
700,650,1350,"COMMUNICATIONS",3.7099,"G"
710,650,1360,"NATURAL SCIENCE",3.8373,"G"
650,680,1330,"LIBERAL ARTS",2.5724,"G"
520,640,1160,"LIBERAL ARTS",3.6474,"G"
560,630,1190,"LIBERAL ARTS",2.8482,"G"
520,390,910,"LIBERAL ARTS",3.4057,"G"
710,680,1390,"LIBERAL ARTS",3.9368,"G"
790,580,1370,"BUSINESS",3.6397,"G"
650,650,1300,"ENGINEERING",3.1052,"G"
710,610,1320,"LIBERAL ARTS",2.6766,"G"
620,650,1270,"LIBERAL ARTS",3.6052,"G"
540,610,1150,"ENGINEERING",3.4407,"G"
410,470,880,"LIBERAL ARTS",2.7121,"G"
630,690,1320,"LIBERAL ARTS",3.8596,"G"
690,740,1430,"NATURAL SCIENCE",3.8759,"G"
620,620,1240,"NATURAL SCIENCE",3.5495,"G"
590,590,1180,"LIBERAL ARTS",3.3177,"G"
540,630,1170,"NATURAL SCIENCE",3.3853,"G"
560,530,1090,"LIBERAL ARTS",2.8529,"G"
650,550,1200,"LIBERAL ARTS",3.4454,"G"
670,680,1350,"NATURAL SCIENCE",3.8103,"G"
640,550,1190,"COMMUNICATIONS",2.4051,"G"
760,750,1510,"ENGINEERING",2.7515,"G"
580,640,1220,"NATURAL SCIENCE",3.469,"G"
760,800,1560,"ENGINEERING",3.863,"G"
640,620,1260,"LIBERAL ARTS",3.3728,"G"
460,570,1030,"LIBERAL ARTS",2.8582,"G"
570,680,1250,"BUSINESS",3.5566,"G"
730,640,1370,"COMMUNICATIONS",3.8181,"G"
590,670,1260,"ENGINEERING",2.9682,"G"
720,520,1240,"LIBERAL ARTS",3.5268,"G"
720,640,1360,"NATURAL SCIENCE",3.5819,"G"
510,660,1170,"LIBERAL ARTS",2.4416,"G"
600,580,1180,"EDUCATION",3.1075,"G"
720,600,1320,"COMMUNICATIONS",3.5531,"G"
710,520,1230,"NATURAL SCIENCE",3.9548,"G"
590,540,1130,"COMMUNICATIONS",3.7203,"G"
510,590,1100,"ENGINEERING",2.3375,"G"
630,540,1170,"LIBERAL ARTS",3.23,"G"
590,790,1380,"NATURAL SCIENCE",3.606,"G"
490,690,1180,"ENGINEERING",3.68,"G"
610,680,1290,"ENGINEERING",3.1711,"G"
680,690,1370,"BUSINESS",3.6538,"G"
650,710,1360,"ENGINEERING",2.5878,"G"
690,710,1400,"BUSINESS",3.2057,"G"
680,730,1410,"NATURAL SCIENCE",2.8974,"G"
370,500,870,"LIBERAL ARTS",2.9925,"G"
630,600,1230,"LIBERAL ARTS",3.8188,"G"
440,630,1070,"FINE ARTS",3.1197,"G"
660,670,1330,"ENGINEERING",3.5067,"G"
610,620,1230,"LIBERAL ARTS",2.9607,"G"
680,450,1130,"LIBERAL ARTS",3.6276,"G"
610,560,1170,"NATURAL SCIENCE",3.4135,"G"
610,640,1250,"LIBERAL ARTS",3.5735,"G"
560,660,1220,"ENGINEERING",3.789,"G"
680,660,1340,"COMMUNICATIONS",3.9302,"G"
590,670,1260,"NATURAL SCIENCE",2.1904,"G"
600,620,1220,"COMMUNICATIONS",3.4742,"G"
510,530,1040,"LIBERAL ARTS",3.2647,"G"
670,720,1390,"LIBERAL ARTS",2.5227,"G"
630,550,1180,"COMMUNICATIONS",3.6329,"G"
650,560,1210,"LIBERAL ARTS",2.7211,"G"
730,470,1200,"COMMUNICATIONS",3.1041,"G"
630,710,1340,"NATURAL SCIENCE",3.916,"G"
540,480,1020,"LIBERAL ARTS",3.3557,"G"
800,800,1600,"ENGINEERING",3.3086,"G"
500,580,1080,"EDUCATION",3.0775,"G"
700,560,1260,"LIBERAL ARTS",3.6435,"G"
720,550,1270,"LIBERAL ARTS",3.7157,"G"
530,600,1130,"FINE ARTS",3.2543,"G"
580,640,1220,"LIBERAL ARTS",3.4827,"G"
560,740,1300,"BUSINESS",3.1074,"G"
560,580,1140,"LIBERAL ARTS",3.0865,"G"
590,670,1260,"LIBERAL ARTS",2.033,"G"
680,800,1480,"COMMUNICATIONS",3.1811,"G"
650,660,1310,"NATURAL SCIENCE",3.4188,"G"
440,470,910,"LIBERAL ARTS",2.6949,"G"
680,670,1350,"COMMUNICATIONS",3.4827,"G"
580,690,1270,"LIBERAL ARTS",2.9452,"G"
640,600,1240,"ARCHITECTURE",3.4571,"G"
520,530,1050,"ENGINEERING",2.4296,"G"
590,690,1280,"NATURAL SCIENCE",2.6163,"G"
620,610,1230,"COMMUNICATIONS",3.0892,"G"
540,520,1060,"LIBERAL ARTS",2.464,"G"
530,600,1130,"EDUCATION",3.1052,"G"
590,660,1250,"ENGINEERING",3.4519,"G"
590,500,1090,"LIBERAL ARTS",3.1679,"G"
560,590,1150,"LIBERAL ARTS",2.9814,"G"
540,670,1210,"LIBERAL ARTS",3.6551,"G"
600,720,1320,"NATURAL SCIENCE",3.7417,"G"
610,680,1290,"NATURAL SCIENCE",2.6402,"G"
570,470,1040,"BUSINESS",3.0897,"G"
480,600,1080,"NATURAL SCIENCE",2.928,"G"
530,790,1320,"ENGINEERING",2.875,"G"
530,530,1060,"NATURAL SCIENCE",3.0089,"G"
540,510,1050,"LIBERAL ARTS",3.6612,"G"
560,620,1180,"LIBERAL ARTS",2.6956,"G"
550,540,1090,"LIBERAL ARTS",3.0606,"G"
480,560,1040,"LIBERAL ARTS",2.9793,"G"
490,530,1020,"BUSINESS",2.756,"G"
540,490,1030,"LIBERAL ARTS",2.9224,"G"
680,740,1420,"LIBERAL ARTS",3.5362,"G"
560,530,1090,"ENGINEERING",2.5328,"G"
680,590,1270,"LIBERAL ARTS",3.2892,"G"
610,650,1260,"LIBERAL ARTS",2.3833,"G"
570,670,1240,"LIBERAL ARTS",2.9224,"G"
610,610,1220,"NATURAL SCIENCE",2.4312,"G"
460,560,1020,"BUSINESS",3.0144,"G"
760,610,1370,"LIBERAL ARTS",3.1496,"G"
530,610,1140,"LIBERAL ARTS",2.6562,"G"
630,650,1280,"FINE ARTS",3.6033,"G"
510,630,1140,"ENGINEERING",3.3015,"G"
760,630,1390,"NATURAL SCIENCE",3.0962,"G"
690,720,1410,"ENGINEERING",2.8642,"G"
500,550,1050,"LIBERAL ARTS",2.6315,"G"
670,670,1340,"ENGINEERING",2.8437,"G"
560,620,1180,"BUSINESS",3.646,"G"
580,550,1130,"EDUCATION",3.1847,"G"
590,650,1240,"NATURAL SCIENCE",3.0083,"G"
650,630,1280,"LIBERAL ARTS",2.5241,"G"
660,720,1380,"ENGINEERING",3.3142,"G"
630,690,1320,"LIBERAL ARTS",3.7573,"G"
470,610,1080,"NATURAL SCIENCE",3.2992,"G"
470,580,1050,"LIBERAL ARTS",3.4537,"G"
500,480,980,"NATURAL SCIENCE",2.9375,"G"
580,660,1240,"LIBERAL ARTS",3.9062,"G"
540,590,1130,"NATURAL SCIENCE",2.664,"G"
600,630,1230,"ENGINEERING",2.9857,"G"
510,560,1070,"ENGINEERING",2.6899,"G"
580,630,1210,"ENGINEERING",2.5483,"G"
690,740,1430,"NATURAL SCIENCE",3.8217,"G"
630,600,1230,"LIBERAL ARTS",2.7183,"G"
730,630,1360,"LIBERAL ARTS",3.7758,"G"
630,600,1230,"NATURAL SCIENCE",3.325,"G"
660,660,1320,"NATURAL SCIENCE",3.3385,"G"
610,710,1320,"NATURAL SCIENCE",2.7395,"G"
620,670,1290,"NATURAL SCIENCE",3.3214,"G"
620,740,1360,"ENGINEERING",3.94,"G"
530,660,1190,"LIBERAL ARTS",3.4411,"G"
600,650,1250,"BUSINESS",3.8297,"G"
620,500,1120,"LIBERAL ARTS",2.9224,"G"
750,720,1470,"BUSINESS",3.9055,"G"
400,460,860,"LIBERAL ARTS",3.028,"G"
550,690,1240,"LIBERAL ARTS",2.5304,"G"
670,630,1300,"LIBERAL ARTS",3.0294,"G"
560,660,1220,"NATURAL SCIENCE",3.4201,"G"
660,800,1460,"NATURAL SCIENCE",3.7467,"G"
490,570,1060,"BUSINESS",3.7606,"G"
760,710,1470,"BUSINESS",3.3846,"G"
590,700,1290,"ENGINEERING",3.1241,"G"
490,520,1010,"ENGINEERING",2.9819,"G"
560,470,1030,"BUSINESS",2.9375,"G"
650,500,1150,"LIBERAL ARTS",3.53,"G"
660,580,1240,"ENGINEERING",3.8016,"G"
610,530,1140,"LIBERAL ARTS",2.4927,"G"
520,590,1110,"BUSINESS",3.2164,"G"
660,660,1320,"ENGINEERING",3.3652,"G"
560,610,1170,"LIBERAL ARTS",3.0186,"G"
520,600,1120,"LIBERAL ARTS",3.9464,"G"
670,720,1390,"BUSINESS",4,"G"
650,590,1240,"LIBERAL ARTS",3.4482,"G"
730,750,1480,"NATURAL SCIENCE",3.5312,"G"
600,550,1150,"LIBERAL ARTS",2.809,"G"
500,490,990,"NATURAL SCIENCE",3.3488,"G"
710,680,1390,"BUSINESS",3.9469,"G"
460,610,1070,"BUSINESS",3.0297,"G"
620,710,1330,"ENGINEERING",3.1755,"G"
590,670,1260,"BUSINESS",3.2539,"G"
450,590,1040,"LIBERAL ARTS",2.983,"G"
700,710,1410,"ENGINEERING",3.9752,"G"
710,800,1510,"ENGINEERING",3.8562,"G"
500,610,1110,"BUSINESS",3.5326,"G"
690,640,1330,"BUSINESS",3.3482,"G"
600,570,1170,"BUSINESS",3.2272,"G"
600,650,1250,"ENGINEERING",2.6315,"G"
650,550,1200,"LIBERAL ARTS",2.6446,"G"
600,590,1190,"LIBERAL ARTS",2.9196,"G"
470,630,1100,"NATURAL SCIENCE",3.4476,"G"
580,580,1160,"LIBERAL ARTS",3.1678,"G"
540,550,1090,"LIBERAL ARTS",3.4036,"G"
680,580,1260,"NATURAL SCIENCE",3.1869,"G"
680,550,1230,"LIBERAL ARTS",3.459,"G"
550,600,1150,"LIBERAL ARTS",3.2605,"G"
620,570,1190,"NATURAL SCIENCE",3.3109,"G"
570,580,1150,"NATURAL SCIENCE",3.3275,"G"
700,710,1410,"NATURAL SCIENCE",4,"G"
530,610,1140,"NATURAL SCIENCE",2.6301,"G"
650,740,1390,"BUSINESS",3.7931,"G"
760,640,1400,"COMMUNICATIONS",4,"G"
520,520,1040,"NATURAL SCIENCE",2.9172,"G"
580,600,1180,"ENGINEERING",3.1063,"G"
490,620,1110,"BUSINESS",3.9274,"G"
620,790,1410,"ENGINEERING",3.7741,"G"
580,560,1140,"BUSINESS",3.5185,"G"
660,690,1350,"LIBERAL ARTS",3.6935,"G"
610,730,1340,"BUSINESS",3.1238,"G"
650,500,1150,"NATURAL SCIENCE",2.891,"G"
620,610,1230,"LIBERAL ARTS",2.425,"G"
560,500,1060,"NATURAL SCIENCE",3.4299,"G"
550,570,1120,"NATURAL SCIENCE",2.6691,"G"
590,690,1280,"ENGINEERING",2.7677,"G"
470,510,980,"NATURAL SCIENCE",2.787,"G"
410,530,940,"LIBERAL ARTS",3.4653,"G"
460,620,1080,"FINE ARTS",3.8333,"G"
510,530,1040,"NATURAL SCIENCE",3.2568,"G"
590,560,1150,"LIBERAL ARTS",3.1333,"G"
560,590,1150,"COMMUNICATIONS",3.5486,"G"
800,800,1600,"ENGINEERING",4,"G"
620,640,1260,"BUSINESS",3.0243,"G"
670,680,1350,"NATURAL SCIENCE",3.4218,"G"
690,790,1480,"NATURAL SCIENCE",3.704,"G"
620,630,1250,"BUSINESS",3.4574,"G"
600,600,1200,"LIBERAL ARTS",2.6766,"G"
590,800,1390,"LIBERAL ARTS",3.8064,"G"
550,640,1190,"BUSINESS",3.5957,"G"
640,620,1260,"LIBERAL ARTS",3.2604,"G"
640,650,1290,"LIBERAL ARTS",3.2991,"G"
440,490,930,"LIBERAL ARTS",2.5137,"G"
560,510,1070,"NATURAL SCIENCE",3.1111,"G"
650,790,1440,"ENGINEERING",3.624,"G"
620,560,1180,"LIBERAL ARTS",2.2101,"G"
500,570,1070,"LIBERAL ARTS",2.7019,"G"
570,580,1150,"BUSINESS",3.2113,"G"
610,650,1260,"ENGINEERING",2.7372,"G"
710,790,1500,"ENGINEERING",2.948,"G"
660,660,1320,"ENGINEERING",2.3246,"G"
590,550,1140,"LIBERAL ARTS",2.7153,"G"
610,650,1260,"LIBERAL ARTS",3,"G"
580,760,1340,"ENGINEERING",3.2812,"G"
570,790,1360,"NATURAL SCIENCE",2.704,"G"
630,630,1260,"NATURAL SCIENCE",3.1098,"G"
540,590,1130,"LIBERAL ARTS",2.9126,"G"
440,730,1170,"COMMUNICATIONS",2.8819,"G"
500,580,1080,"NATURAL SCIENCE",3.1916,"G"
610,740,1350,"NATURAL SCIENCE",3.9482,"G"
800,790,1590,"LIBERAL ARTS",2.1843,"G"
670,600,1270,"LIBERAL ARTS",2.8691,"G"
570,650,1220,"ENGINEERING",3.0522,"G"
650,650,1300,"ARCHITECTURE",3.752,"G"
540,450,990,"BUSINESS",3.0956,"G"
790,760,1550,"NATURAL SCIENCE",4,"G"
450,580,1030,"NATURAL SCIENCE",3.1764,"G"
440,560,1000,"FINE ARTS",3.3688,"G"
660,510,1170,"LIBERAL ARTS",2,"G"
600,640,1240,"NATURAL SCIENCE",3.5689,"G"
580,660,1240,"NATURAL SCIENCE",3.5913,"G"
640,540,1180,"LIBERAL ARTS",3.7053,"G"
730,720,1450,"LIBERAL ARTS",3.5048,"G"
550,690,1240,"NATURAL SCIENCE",2.9098,"G"
680,710,1390,"ENGINEERING",2.1,"G"
480,620,1100,"NATURAL SCIENCE",3.7368,"G"
540,570,1110,"NATURAL SCIENCE",2.8571,"G"
650,640,1290,"ENGINEERING",3.1219,"G"
670,730,1400,"LIBERAL ARTS",3.4857,"G"
600,640,1240,"FINE ARTS",2.6299,"G"
630,760,1390,"ENGINEERING",2.5096,"G"
460,770,1230,"NATURAL SCIENCE",3.8928,"G"
580,600,1180,"BUSINESS",2.7619,"G"
640,700,1340,"LIBERAL ARTS",3.653,"G"
730,690,1420,"NATURAL SCIENCE",3.7103,"G"
500,620,1120,"NATURAL SCIENCE",3.4623,"G"
560,580,1140,"LIBERAL ARTS",2.7575,"G"
550,570,1120,"NATURAL SCIENCE",3.5555,"G"
640,710,1350,"NATURAL SCIENCE",3.1884,"G"
450,720,1170,"ENGINEERING",2.2432,"G"
620,700,1320,"NATURAL SCIENCE",2.2076,"G"
770,660,1430,"LIBERAL ARTS",3.4814,"G"
630,750,1380,"LIBERAL ARTS",3.7669,"G"
590,710,1300,"LIBERAL ARTS",3.9005,"G"
700,610,1310,"LIBERAL ARTS",3.4396,"G"
580,620,1200,"LIBERAL ARTS",3.8787,"G"
700,620,1320,"FINE ARTS",3.29,"G"
440,410,850,"LIBERAL ARTS",2.6017,"G"
670,510,1180,"ENGINEERING",3.5578,"G"
450,700,1150,"ENGINEERING",3.4295,"G"
530,580,1110,"NATURAL SCIENCE",2.4307,"G"
570,620,1190,"NATURAL SCIENCE",3.7,"G"
620,700,1320,"ENGINEERING",2.8253,"G"
590,560,1150,"NURSING",3.1357,"G"
650,680,1330,"NATURAL SCIENCE",3.9117,"G"
560,660,1220,"COMMUNICATIONS",3.228,"G"
540,530,1070,"LIBERAL ARTS",2.7155,"G"
590,660,1250,"BUSINESS",3.4134,"G"
610,750,1360,"BUSINESS",3.9065,"G"
450,660,1110,"NATURAL SCIENCE",3.8854,"G"
730,670,1400,"LIBERAL ARTS",2.0138,"G"
510,540,1050,"BUSINESS",3.2932,"G"
490,650,1140,"LIBERAL ARTS",2.228,"G"
540,470,1010,"LIBERAL ARTS",3.3478,"G"
590,590,1180,"LIBERAL ARTS",3.6065,"G"
590,620,1210,"FINE ARTS",3.376,"G"
750,790,1540,"BUSINESS",3.3095,"G"
560,570,1130,"EDUCATION",3.5408,"G"
470,410,880,"LIBERAL ARTS",2.8073,"G"
510,610,1120,"NATURAL SCIENCE",2.6065,"G"
610,580,1190,"LIBERAL ARTS",2.7297,"G"
430,530,960,"NATURAL SCIENCE",2.5869,"G"
540,370,910,"FINE ARTS",2.7156,"G"
570,680,1250,"NATURAL SCIENCE",2.7983,"G"
600,640,1240,"BUSINESS",3.7142,"G"
630,590,1220,"LIBERAL ARTS",2.9666,"G"
480,640,1120,"LIBERAL ARTS",3.1803,"G"
730,800,1530,"LIBERAL ARTS",2.8305,"G"
380,400,780,"LIBERAL ARTS",3.1709,"G"
630,590,1220,"LIBERAL ARTS",3.2872,"G"
440,560,1000,"BUSINESS",3.2909,"G"
530,650,1180,"BUSINESS",3.3114,"G"
580,670,1250,"BUSINESS",3.3207,"G"
470,590,1060,"LIBERAL ARTS",2.8823,"G"
540,750,1290,"NATURAL SCIENCE",2.6466,"G"
490,590,1080,"BUSINESS",2.7731,"G"
500,630,1130,"ENGINEERING",3.4137,"G"
550,660,1210,"NATURAL SCIENCE",2.8016,"G"
430,590,1020,"LIBERAL ARTS",2.898,"G"
600,600,1200,"NATURAL SCIENCE",2.4423,"G"
520,500,1020,"LIBERAL ARTS",3.7835,"G"
700,650,1350,"LIBERAL ARTS",3.2115,"G"
500,660,1160,"LIBERAL ARTS",3.1916,"G"
460,620,1080,"NATURAL SCIENCE",2.7272,"G"
480,580,1060,"LIBERAL ARTS",2.5694,"G"
540,580,1120,"BUSINESS",3.2631,"G"
640,550,1190,"LIBERAL ARTS",3.5233,"G"
550,580,1130,"LIBERAL ARTS",3.1008,"G"
630,610,1240,"NATURAL SCIENCE",2.7592,"G"
610,710,1320,"ENGINEERING",2.867,"G"
700,580,1280,"LIBERAL ARTS",2.6818,"G"
690,700,1390,"ENGINEERING",3.7603,"G"
670,710,1380,"LIBERAL ARTS",3.221,"G"
610,640,1250,"NATURAL SCIENCE",3.4354,"G"
760,750,1510,"LIBERAL ARTS",3.245,"G"
620,520,1140,"LIBERAL ARTS",3.2761,"G"
500,630,1130,"LIBERAL ARTS",3.1226,"G"
550,480,1030,"LIBERAL ARTS",3.4545,"G"
470,520,990,"NATURAL SCIENCE",2.4402,"G"
690,740,1430,"ENGINEERING",3.5703,"G"
580,590,1170,"LIBERAL ARTS",2.4452,"G"
560,490,1050,"LIBERAL ARTS",2.8787,"G"
660,720,1380,"NATURAL SCIENCE",3,"G"
590,650,1240,"BUSINESS",3.2142,"G"
530,580,1110,"NATURAL SCIENCE",2.581,"G"
570,650,1220,"BUSINESS",3.7407,"G"
800,800,1600,"BUSINESS",4,"G"
560,650,1210,"NATURAL SCIENCE",3.2666,"G"
550,670,1220,"ENGINEERING",3.032,"G"
700,790,1490,"ENGINEERING",2.6496,"G"
470,620,1090,"LIBERAL ARTS",3.288,"G"
510,700,1210,"ENGINEERING",3.4087,"G"
450,630,1080,"LIBERAL ARTS",3.0294,"G"
550,670,1220,"NATURAL SCIENCE",2.9383,"G"
660,690,1350,"ENGINEERING",2.7727,"G"
520,670,1190,"LIBERAL ARTS",2.6474,"G"
470,730,1200,"ENGINEERING",2.7028,"G"
670,660,1330,"FINE ARTS",3.4754,"G"
430,570,1000,"BUSINESS",3.8037,"G"
600,660,1260,"ENGINEERING",3.8809,"G"
580,540,1120,"LIBERAL ARTS",2.2148,"G"
710,660,1370,"LIBERAL ARTS",3.2975,"G"
410,510,920,"ENGINEERING",2.0551,"G"
570,600,1170,"BUSINESS",3.3893,"G"
520,530,1050,"LIBERAL ARTS",2.7076,"G"
620,670,1290,"NATURAL SCIENCE",2.3333,"G"
650,650,1300,"LIBERAL ARTS",3.2254,"G"
670,770,1440,"BUSINESS",3.9032,"G"
650,640,1290,"LIBERAL ARTS",3.271,"G"
660,670,1330,"ENGINEERING",3.9542,"G"
500,460,960,"NATURAL SCIENCE",2.6533,"G"
560,690,1250,"LIBERAL ARTS",3.0192,"G"
670,740,1410,"LIBERAL ARTS",3.4642,"G"
570,760,1330,"LIBERAL ARTS",3.9708,"G"
580,600,1180,"NATURAL SCIENCE",3.15,"G"
570,760,1330,"ENGINEERING",3.9794,"G"
550,640,1190,"LIBERAL ARTS",2.548,"G"
460,690,1150,"ENGINEERING",3.6131,"G"
700,780,1480,"LIBERAL ARTS",3.9383,"G"
330,620,950,"NATURAL SCIENCE",3.123,"G"
500,670,1170,"LIBERAL ARTS",3.4761,"G"
480,790,1270,"LIBERAL ARTS",3.5153,"G"
660,570,1230,"NATURAL SCIENCE",2.9236,"G"
560,570,1130,"NATURAL SCIENCE",3.0733,"G"
550,590,1140,"ENGINEERING",2.0764,"G"
550,630,1180,"LIBERAL ARTS",2.3175,"G"
490,660,1150,"LIBERAL ARTS",2.1532,"G"
660,770,1430,"ENGINEERING",4,"G"
640,640,1280,"COMMUNICATIONS",3.7079,"G"
490,520,1010,"LIBERAL ARTS",3.0176,"G"
660,740,1400,"ENGINEERING",3.1052,"G"
530,710,1240,"LIBERAL ARTS",2.75,"G"
650,690,1340,"NATURAL SCIENCE",3.9897,"G"
560,530,1090,"LIBERAL ARTS",2.5967,"G"
500,550,1050,"BUSINESS",2.8842,"G"
440,490,930,"LIBERAL ARTS",2.7166,"G"
470,530,1000,"LIBERAL ARTS",2.7247,"G"
600,610,1210,"LIBERAL ARTS",3.9708,"G"
610,630,1240,"ENGINEERING",3.3239,"G"
450,550,1000,"LIBERAL ARTS",2.8905,"G"
740,640,1380,"ENGINEERING",3.1065,"G"
570,640,1210,"BUSINESS",2.9519,"G"
590,620,1210,"LIBERAL ARTS",2.8333,"G"
540,580,1120,"LIBERAL ARTS",3.4395,"G"
680,670,1350,"BUSINESS",3.6972,"G"
560,470,1030,"LIBERAL ARTS",2.826,"G"
610,550,1160,"LIBERAL ARTS",3.4869,"G"
600,680,1280,"NATURAL SCIENCE",3.7222,"G"
480,520,1000,"BUSINESS",3.2616,"G"
520,580,1100,"BUSINESS",3.3465,"G"
510,590,1100,"LIBERAL ARTS",3.3404,"G"
390,330,720,"LIBERAL ARTS",3.0588,"G"
650,650,1300,"NATURAL SCIENCE",3.7,"G"
690,460,1150,"LIBERAL ARTS",3.5826,"G"
600,570,1170,"BUSINESS",3.16,"G"
550,570,1120,"LIBERAL ARTS",3.5128,"G"
650,640,1290,"LIBERAL ARTS",2.173,"G"
740,670,1410,"LIBERAL ARTS",3.8322,"G"
660,630,1290,"COMMUNICATIONS",3.1981,"G"
690,720,1410,"BUSINESS",3.5833,"G"
710,650,1360,"LIBERAL ARTS",2.3173,"G"
510,560,1070,"LIBERAL ARTS",3.5,"G"
450,570,1020,"LIBERAL ARTS",3.2121,"G"
550,650,1200,"NATURAL SCIENCE",2.5478,"G"
460,610,1070,"EDUCATION",3.475,"G"
680,760,1440,"ENGINEERING",3.3673,"G"
530,570,1100,"ENGINEERING",3.3304,"G"
650,670,1320,"BUSINESS",3.8362,"G"
500,580,1080,"BUSINESS",3.5864,"G"
630,540,1170,"LIBERAL ARTS",2.9842,"G"
570,590,1160,"LIBERAL ARTS",3.5436,"G"
520,770,1290,"NATURAL SCIENCE",3.0144,"G"
660,770,1430,"ENGINEERING",3.3529,"G"
670,580,1250,"LIBERAL ARTS",2.7967,"G"
650,680,1330,"BUSINESS",3.6632,"G"
430,650,1080,"BUSINESS",3.5042,"G"
600,620,1220,"LIBERAL ARTS",3.0869,"G"
710,760,1470,"NATURAL SCIENCE",3.6907,"G"
610,660,1270,"COMMUNICATIONS",3.1296,"G"
550,520,1070,"BUSINESS",2.9909,"G"
530,640,1170,"BUSINESS",3.2892,"G"
540,650,1190,"LIBERAL ARTS",3.6218,"G"
440,600,1040,"LIBERAL ARTS",3.7652,"G"
670,700,1370,"NATURAL SCIENCE",2.4563,"G"
560,570,1130,"LIBERAL ARTS",2.8583,"G"
500,610,1110,"LIBERAL ARTS",2.15,"G"
530,460,990,"NATURAL SCIENCE",3.0364,"G"
770,790,1560,"NATURAL SCIENCE",3.5932,"G"
520,540,1060,"COMMUNICATIONS",3.8192,"G"
620,560,1180,"LIBERAL ARTS",3.6106,"G"
440,440,880,"LIBERAL ARTS",2.819,"G"
620,660,1280,"COMMUNICATIONS",3.3467,"G"
540,610,1150,"ENGINEERING",3.3057,"G"
710,770,1480,"ENGINEERING",3.8521,"G"
540,520,1060,"FINE ARTS",3.431,"G"
550,630,1180,"LIBERAL ARTS",2.6315,"G"
630,590,1220,"LIBERAL ARTS",3.4672,"G"
650,770,1420,"ENGINEERING",3.8244,"G"
510,560,1070,"LIBERAL ARTS",2.725,"G"
640,720,1360,"BUSINESS",3.8809,"G"
630,680,1310,"ENGINEERING",3.8014,"G"
470,790,1260,"ENGINEERING",3.4074,"G"
490,560,1050,"LIBERAL ARTS",2.509,"G"
540,540,1080,"LIBERAL ARTS",2.5609,"G"
600,600,1200,"NATURAL SCIENCE",3.7924,"G"
620,540,1160,"FINE ARTS",3.5937,"G"
710,740,1450,"NATURAL SCIENCE",3.9803,"G"
550,520,1070,"LIBERAL ARTS",3.7297,"G"
500,640,1140,"ENGINEERING",3.7735,"G"
530,550,1080,"BUSINESS",3.685,"G"
650,690,1340,"LIBERAL ARTS",3.2615,"G"
610,550,1160,"LIBERAL ARTS",3.008,"G"
680,510,1190,"LIBERAL ARTS",2.6016,"G"
560,570,1130,"NURSING",3.7735,"G"
640,790,1430,"ENGINEERING",3.8108,"G"
560,590,1150,"LIBERAL ARTS",2.448,"G"
570,620,1190,"NATURAL SCIENCE",2.2477,"G"
640,760,1400,"NATURAL SCIENCE",2.9617,"G"
660,750,1410,"NATURAL SCIENCE",3.678,"G"
670,620,1290,"NATURAL SCIENCE",1.9326,"G"
450,580,1030,"BUSINESS",2.8292,"G"
590,510,1100,"BUSINESS",3.3478,"G"
410,720,1130,"LIBERAL ARTS",3.3453,"G"
590,630,1220,"LIBERAL ARTS",2.7611,"G"
470,570,1040,"LIBERAL ARTS",3.2743,"G"
490,600,1090,"LIBERAL ARTS",2.9761,"G"
670,650,1320,"LIBERAL ARTS",3.3431,"G"
550,510,1060,"NATURAL SCIENCE",2.7567,"G"
720,670,1390,"ENGINEERING",3.5677,"G"
750,580,1330,"LIBERAL ARTS",2.5,"G"
440,420,860,"LIBERAL ARTS",3.1818,"G"
460,610,1070,"LIBERAL ARTS",3.0707,"G"
670,790,1460,"BUSINESS",3.8943,"G"
660,710,1370,"COMMUNICATIONS",3.6901,"G"
480,550,1030,"NATURAL SCIENCE",2.5454,"G"
770,730,1500,"LIBERAL ARTS",3.5826,"G"
610,610,1220,"EDUCATION",3.6666,"G"
480,660,1140,"ENGINEERING",2.7954,"G"
580,710,1290,"NATURAL SCIENCE",3.5177,"G"
710,680,1390,"BUSINESS",3.8686,"G"
530,540,1070,"COMMUNICATIONS",3.3367,"G"
570,580,1150,"NATURAL SCIENCE",2.75,"G"
400,580,980,"NATURAL SCIENCE",2.1956,"G"
440,580,1020,"LIBERAL ARTS",3.3486,"G"
510,740,1250,"NATURAL SCIENCE",2.923,"G"
480,610,1090,"BUSINESS",3.5934,"G"
700,690,1390,"LIBERAL ARTS",3.7763,"G"
680,630,1310,"NATURAL SCIENCE",3.6033,"G"
800,740,1540,"FINE ARTS",3.8716,"G"
530,560,1090,"LIBERAL ARTS",3.1,"G"
630,660,1290,"ENGINEERING",3.96,"G"
590,530,1120,"EDUCATION",3.1,"G"
580,570,1150,"LIBERAL ARTS",1.9291,"G"
520,640,1160,"BUSINESS",3.5937,"G"
460,620,1080,"NATURAL SCIENCE",3.4077,"G"
640,700,1340,"FINE ARTS",3.5284,"G"
560,650,1210,"BUSINESS",2.6036,"G"
530,520,1050,"NATURAL SCIENCE",2.7,"G"
560,600,1160,"NATURAL SCIENCE",2.3963,"G"
630,740,1370,"LIBERAL ARTS",3.6461,"G"
390,550,940,"LIBERAL ARTS",2.3773,"G"
620,590,1210,"COMMUNICATIONS",4,"G"
540,520,1060,"NATURAL SCIENCE",2.0709,"G"
710,630,1340,"LIBERAL ARTS",3.8285,"G"
590,690,1280,"LIBERAL ARTS",2.7589,"G"
690,660,1350,"BUSINESS",3.2123,"G"
500,600,1100,"ENGINEERING",3.2926,"G"
700,790,1490,"ENGINEERING",3.7777,"G"
520,660,1180,"ENGINEERING",3.0932,"G"
720,750,1470,"BUSINESS",3.9612,"G"
540,590,1130,"NATURAL SCIENCE",2.6916,"G"
520,600,1120,"NATURAL SCIENCE",2.4461,"G"
460,620,1080,"LIBERAL ARTS",2.7213,"G"
540,660,1200,"BUSINESS",3.521,"G"
580,690,1270,"ENGINEERING",2.0408,"G"
500,580,1080,"LIBERAL ARTS",2.4876,"G"
510,580,1090,"LIBERAL ARTS",2.5714,"G"
510,580,1090,"LIBERAL ARTS",2.6732,"G"
540,790,1330,"NATURAL SCIENCE",3.9552,"G"
690,710,1400,"BUSINESS",3.7032,"G"
540,430,970,"FINE ARTS",3.5,"G"
620,580,1200,"LIBERAL ARTS",3.5,"G"
640,620,1260,"LIBERAL ARTS",3.7368,"G"
760,630,1390,"NATURAL SCIENCE",3.0869,"G"
650,700,1350,"COMMUNICATIONS",3.0963,"G"
660,630,1290,"BUSINESS",3.2822,"G"
500,570,1070,"NATURAL SCIENCE",3.2666,"G"
650,680,1330,"NATURAL SCIENCE",2.6541,"G"
590,550,1140,"LIBERAL ARTS",3.7398,"G"
640,680,1320,"BUSINESS",2.9629,"G"
740,720,1460,"NATURAL SCIENCE",4,"G"
580,580,1160,"BUSINESS",3.4,"G"
700,640,1340,"NATURAL SCIENCE",3.609,"G"
640,570,1210,"LIBERAL ARTS",3.9449,"G"
680,560,1240,"FINE ARTS",3.3135,"G"
570,590,1160,"NATURAL SCIENCE",2.0153,"G"
650,630,1280,"NATURAL SCIENCE",3.1525,"G"
540,590,1130,"LIBERAL ARTS",3.0576,"G"
580,620,1200,"LIBERAL ARTS",3.0211,"G"
540,580,1120,"LIBERAL ARTS",3.238,"G"
580,720,1300,"ENGINEERING",3.4769,"G"
610,620,1230,"NATURAL SCIENCE",3.6893,"G"
780,720,1500,"NATURAL SCIENCE",3.9815,"G"
760,800,1560,"NATURAL SCIENCE",3.9815,"G"
600,620,1220,"NATURAL SCIENCE",3.2539,"G"
540,730,1270,"NATURAL SCIENCE",3.8508,"G"
470,540,1010,"BUSINESS",2.879,"G"
590,630,1220,"EDUCATION",3.9482,"G"
490,720,1210,"ENGINEERING",3.9109,"G"
610,720,1330,"NATURAL SCIENCE",3.5263,"G"
670,680,1350,"FINE ARTS",3.4573,"G"
630,770,1400,"LIBERAL ARTS",3.5818,"G"
600,720,1320,"COMMUNICATIONS",3.3987,"G"
450,490,940,"NATURAL SCIENCE",2.6746,"G"
580,560,1140,"BUSINESS",2.7058,"G"
530,620,1150,"BUSINESS",3.3364,"G"
770,610,1380,"LIBERAL ARTS",3.116,"G"
610,600,1210,"FINE ARTS",3.1151,"G"
510,570,1080,"COMMUNICATIONS",3.0467,"G"
660,670,1330,"LIBERAL ARTS",3.1476,"G"
570,600,1170,"LIBERAL ARTS",2.8878,"G"
610,720,1330,"NATURAL SCIENCE",2.5434,"G"
610,560,1170,"LIBERAL ARTS",3.5526,"G"
600,540,1140,"LIBERAL ARTS",3.2058,"G"
410,700,1110,"ENGINEERING",3.1376,"G"
540,480,1020,"NATURAL SCIENCE",3.0813,"G"
650,720,1370,"ENGINEERING",3.8048,"G"
440,610,1050,"LIBERAL ARTS",2.5877,"G"
500,610,1110,"LIBERAL ARTS",3.4224,"G"
670,600,1270,"LIBERAL ARTS",3.6869,"G"
590,620,1210,"LIBERAL ARTS",3.5258,"G"
420,690,1110,"NATURAL SCIENCE",3.1981,"G"
540,660,1200,"BUSINESS",3.099,"G"
690,650,1340,"LIBERAL ARTS",3.5108,"G"
610,710,1320,"NATURAL SCIENCE",3.3484,"G"
690,670,1360,"NATURAL SCIENCE",3.3796,"G"
540,450,990,"COMMUNICATIONS",2.6901,"G"
730,570,1300,"LIBERAL ARTS",2.7692,"G"
710,770,1480,"BUSINESS",3.84,"G"
580,670,1250,"EDUCATION",3.3109,"G"
630,590,1220,"NATURAL SCIENCE",3.5825,"G"
590,570,1160,"ENGINEERING",3.0384,"G"
610,580,1190,"LIBERAL ARTS",2.8654,"G"
700,790,1490,"BUSINESS",4,"G"
580,450,1030,"LIBERAL ARTS",2.0563,"G"
600,580,1180,"NATURAL SCIENCE",3.8695,"G"
510,610,1120,"NATURAL SCIENCE",2.7606,"G"
510,570,1080,"LIBERAL ARTS",3.3055,"G"
550,610,1160,"NATURAL SCIENCE",2.876,"G"
540,670,1210,"NATURAL SCIENCE",3.1157,"G"
660,620,1280,"LIBERAL ARTS",3.5773,"G"
570,650,1220,"ENGINEERING",3.2377,"G"
580,680,1260,"NATURAL SCIENCE",3.1027,"G"
500,630,1130,"NATURAL SCIENCE",3.2613,"G"
720,600,1320,"LIBERAL ARTS",3.602,"G"
290,440,730,"LIBERAL ARTS",2.1693,"G"
440,650,1090,"LIBERAL ARTS",3.0285,"G"
780,710,1490,"ENGINEERING",3.024,"G"
480,720,1200,"NATURAL SCIENCE",3.8809,"G"
660,700,1360,"LIBERAL ARTS",3.1495,"G"
660,560,1220,"NATURAL SCIENCE",2.3097,"G"
560,570,1130,"NATURAL SCIENCE",3.09,"G"
670,690,1360,"ENGINEERING",2.6442,"G"
590,620,1210,"LIBERAL ARTS",3.7008,"G"
800,800,1600,"LIBERAL ARTS",3.6557,"G"
710,570,1280,"LIBERAL ARTS",3.8,"G"
650,550,1200,"LIBERAL ARTS",2.87,"G"
580,800,1380,"NATURAL SCIENCE",3.3388,"G"
620,560,1180,"NATURAL SCIENCE",2.976,"G"
710,680,1390,"NATURAL SCIENCE",3.8846,"G"
530,560,1090,"LIBERAL ARTS",2.872,"G"
650,800,1450,"ENGINEERING",3.6126,"G"
500,670,1170,"SOCIAL WORK",2.9236,"G"
590,660,1250,"LIBERAL ARTS",3.3606,"G"
590,570,1160,"LIBERAL ARTS",3.4122,"G"
420,660,1080,"LIBERAL ARTS",2.9718,"G"
650,650,1300,"LIBERAL ARTS",3.7435,"G"
560,650,1210,"EDUCATION",3.8165,"G"
560,640,1200,"BUSINESS",3.4159,"G"
620,630,1250,"NATURAL SCIENCE",3.1328,"G"
520,710,1230,"NATURAL SCIENCE",2.9177,"G"
630,680,1310,"NATURAL SCIENCE",3.25,"G"
610,800,1410,"NATURAL SCIENCE",3.8,"G"
560,760,1320,"ENGINEERING",3.4552,"G"
700,740,1440,"ENGINEERING",2.5374,"G"
730,700,1430,"ENGINEERING",3.2483,"G"
630,590,1220,"NATURAL SCIENCE",3.0104,"G"
590,490,1080,"LIBERAL ARTS",3.1153,"G"
690,750,1440,"COMMUNICATIONS",3.8993,"G"
610,540,1150,"NATURAL SCIENCE",2.5,"G"
480,510,990,"LIBERAL ARTS",2.9626,"G"
530,530,1060,"NATURAL SCIENCE",2.8196,"G"
540,560,1100,"NATURAL SCIENCE",3.6118,"G"
590,530,1120,"LIBERAL ARTS",2.2647,"G"
570,490,1060,"BUSINESS",3.0079,"G"
540,540,1080,"LIBERAL ARTS",3.0645,"G"
550,530,1080,"LIBERAL ARTS",2.9454,"G"
800,710,1510,"LIBERAL ARTS",3.7716,"G"
590,710,1300,"ENGINEERING",3.1206,"G"
590,580,1170,"LIBERAL ARTS",3.3759,"G"
530,610,1140,"NATURAL SCIENCE",2.4666,"G"
650,640,1290,"BUSINESS",3.112,"G"
550,600,1150,"BUSINESS",3.5568,"G"
480,470,950,"COMMUNICATIONS",3.923,"G"
570,580,1150,"EDUCATION",3.3272,"G"
540,590,1130,"COMMUNICATIONS",3.8076,"G"
680,660,1340,"BUSINESS",3.4303,"G"
510,720,1230,"NATURAL SCIENCE",2.6947,"G"
600,750,1350,"NATURAL SCIENCE",4,"G"
710,800,1510,"LIBERAL ARTS",3.6092,"G"
700,790,1490,"BUSINESS",4,"G"
570,590,1160,"ENGINEERING",3.0463,"G"
660,480,1140,"COMMUNICATIONS",3.1271,"G"
390,650,1040,"ENGINEERING",3.4705,"G"
470,560,1030,"LIBERAL ARTS",3.7711,"G"
500,740,1240,"LIBERAL ARTS",2.4809,"G"
530,760,1290,"NATURAL SCIENCE",3.1159,"G"
310,540,850,"BUSINESS",3.0744,"G"
800,680,1480,"BUSINESS",3.5625,"G"
420,630,1050,"LIBERAL ARTS",2.6796,"G"
500,590,1090,"NURSING",2.9855,"G"
630,660,1290,"NATURAL SCIENCE",3.0491,"G"
490,490,980,"LIBERAL ARTS",2.3589,"G"
480,590,1070,"LIBERAL ARTS",3.3018,"G"
690,670,1360,"ENGINEERING",3.4042,"G"
640,670,1310,"NATURAL SCIENCE",3.2083,"G"
500,580,1080,"NATURAL SCIENCE",2.0173,"G"
700,670,1370,"ENGINEERING",2.0781,"G"
600,660,1260,"NATURAL SCIENCE",3.6548,"G"
670,590,1260,"NURSING",2.6279,"G"
560,520,1080,"COMMUNICATIONS",3.3673,"G"
710,700,1410,"BUSINESS",4,"G"
550,720,1270,"ENGINEERING",3.6752,"G"
510,630,1140,"ENGINEERING",3.3738,"G"
500,520,1020,"LIBERAL ARTS",2.1849,"G"
660,670,1330,"FINE ARTS",3.675,"G"
620,640,1260,"NATURAL SCIENCE",3.1666,"G"
710,640,1350,"LIBERAL ARTS",3.6434,"G"
410,660,1070,"LIBERAL ARTS",3.0521,"G"
670,570,1240,"NATURAL SCIENCE",3.3027,"G"
680,700,1380,"LIBERAL ARTS",3.3175,"G"
690,800,1490,"ENGINEERING",3.4551,"G"
710,630,1340,"LIBERAL ARTS",3.6111,"G"
380,760,1140,"NATURAL SCIENCE",3.789,"G"
460,710,1170,"NATURAL SCIENCE",3.4723,"G"
530,570,1100,"ENGINEERING",2.8954,"G"
270,530,800,"NATURAL SCIENCE",3.048,"G"
430,730,1160,"NATURAL SCIENCE",3.4296,"G"
590,680,1270,"LIBERAL ARTS",3.5433,"G"
520,670,1190,"NATURAL SCIENCE",3.2019,"G"
600,710,1310,"NATURAL SCIENCE",3.8523,"G"
380,590,970,"LIBERAL ARTS",2.9029,"G"
620,700,1320,"BUSINESS",3.2109,"G"
560,580,1140,"BUSINESS",3.6551,"G"
560,530,1090,"LIBERAL ARTS",2.9417,"G"
310,440,750,"LIBERAL ARTS",3.2192,"G"
640,670,1310,"LIBERAL ARTS",3.3211,"G"
620,710,1330,"ENGINEERING",3.8813,"G"
530,680,1210,"NATURAL SCIENCE",2.5092,"G"
550,520,1070,"LIBERAL ARTS",2.5633,"G"
750,630,1380,"BUSINESS",3.8875,"G"
680,700,1380,"ENGINEERING",4,"G"
670,470,1140,"LIBERAL ARTS",3.3913,"G"
540,610,1150,"ENGINEERING",2.9763,"G"
430,490,920,"LIBERAL ARTS",2.3931,"G"
750,630,1380,"BUSINESS",3.9798,"G"
590,560,1150,"LIBERAL ARTS",2.923,"G"
760,670,1430,"LIBERAL ARTS",3.9671,"G"
630,520,1150,"COMMUNICATIONS",2.3119,"G"
620,470,1090,"LIBERAL ARTS",3.6136,"G"
610,570,1180,"EDUCATION",3.7476,"G"
540,680,1220,"BUSINESS",3.7818,"G"
430,500,930,"NATURAL SCIENCE",2.05,"G"
620,590,1210,"LIBERAL ARTS",3.4811,"G"
560,670,1230,"LIBERAL ARTS",2.2916,"G"
510,700,1210,"LIBERAL ARTS",2.7798,"G"
500,640,1140,"BUSINESS",2.6517,"G"
580,640,1220,"EDUCATION",3.7362,"G"
600,800,1400,"ENGINEERING",2.9655,"G"
650,620,1270,"NATURAL SCIENCE",3.2312,"G"
600,550,1150,"LIBERAL ARTS",2.9302,"G"
730,660,1390,"COMMUNICATIONS",3.7446,"G"
530,690,1220,"NATURAL SCIENCE",3.032,"G"
550,790,1340,"LIBERAL ARTS",3.854,"G"
470,700,1170,"LIBERAL ARTS",3.2732,"G"
530,640,1170,"NATURAL SCIENCE",3.3524,"G"
750,680,1430,"NATURAL SCIENCE",3.6714,"G"
500,470,970,"FINE ARTS",3.7525,"G"
580,450,1030,"BUSINESS",2.8989,"G"
600,580,1180,"LIBERAL ARTS",3.5446,"G"
540,570,1110,"LIBERAL ARTS",2.7155,"G"
530,670,1200,"LIBERAL ARTS",2.6417,"G"
580,540,1120,"LIBERAL ARTS",3.5596,"G"
620,470,1090,"LIBERAL ARTS",2.4135,"G"
520,590,1110,"EDUCATION",3.7238,"G"
610,640,1250,"NATURAL SCIENCE",3.0582,"G"
570,480,1050,"COMMUNICATIONS",3.3977,"G"
430,410,840,"LIBERAL ARTS",3.625,"G"
580,520,1100,"LIBERAL ARTS",2.7345,"G"
670,660,1330,"COMMUNICATIONS",3.4905,"G"
600,600,1200,"LIBERAL ARTS",2.913,"G"
530,560,1090,"BUSINESS",3.2828,"G"
610,530,1140,"LIBERAL ARTS",3.2941,"G"
630,580,1210,"NATURAL SCIENCE",3.0157,"G"
570,630,1200,"LIBERAL ARTS",3.0769,"G"
610,610,1220,"LIBERAL ARTS",3.4473,"G"
550,650,1200,"ENGINEERING",3.6231,"G"
590,710,1300,"BUSINESS",3.9104,"G"
490,540,1030,"LIBERAL ARTS",3.1826,"G"
610,720,1330,"ENGINEERING",3.9722,"G"
560,670,1230,"ENGINEERING",3.3125,"G"
620,620,1240,"LIBERAL ARTS",3.5,"G"
420,680,1100,"NATURAL SCIENCE",3.0778,"G"
650,590,1240,"EDUCATION",3.6209,"G"
630,740,1370,"BUSINESS",3.4955,"G"
430,370,800,"NATURAL SCIENCE",2.8549,"G"
490,500,990,"NATURAL SCIENCE",2.9827,"G"
590,620,1210,"LIBERAL ARTS",2.8518,"G"
640,750,1390,"LIBERAL ARTS",3.325,"G"
570,630,1200,"ENGINEERING",3.4173,"G"
530,480,1010,"LIBERAL ARTS",3.147,"G"
530,600,1130,"NATURAL SCIENCE",3.2991,"G"
580,560,1140,"FINE ARTS",3.6056,"G"
610,660,1270,"LIBERAL ARTS",2.5161,"G"
580,570,1150,"FINE ARTS",2.8515,"G"
610,570,1180,"LIBERAL ARTS",3.5251,"G"
580,630,1210,"COMMUNICATIONS",3.6315,"G"
580,590,1170,"LIBERAL ARTS",3.6052,"G"
650,590,1240,"NATURAL SCIENCE",3.3391,"G"
710,770,1480,"ENGINEERING",3.9732,"G"
520,500,1020,"BUSINESS",2.606,"G"
640,670,1310,"BUSINESS",3.3243,"G"
610,610,1220,"LIBERAL ARTS",3.9449,"G"
600,540,1140,"LIBERAL ARTS",2.5338,"G"
570,550,1120,"LIBERAL ARTS",3.4356,"G"
480,790,1270,"ENGINEERING",3.4562,"G"
380,510,890,"NATURAL SCIENCE",3.3021,"G"
580,650,1230,"BUSINESS",2.9456,"G"
500,560,1060,"ENGINEERING",2.5786,"G"
480,460,940,"LIBERAL ARTS",2.9482,"G"
580,620,1200,"BUSINESS",3.7692,"G"
670,700,1370,"NATURAL SCIENCE",3.7796,"G"
560,580,1140,"BUSINESS",2.9684,"G"
640,590,1230,"LIBERAL ARTS",3.1081,"G"
600,620,1220,"LIBERAL ARTS",2.6031,"G"
570,670,1240,"LIBERAL ARTS",3.2352,"G"
610,790,1400,"NATURAL SCIENCE",3.8646,"G"
560,690,1250,"LIBERAL ARTS",3.3157,"G"
560,710,1270,"BUSINESS",3.8101,"G"
610,480,1090,"EDUCATION",3.8909,"G"
620,590,1210,"LIBERAL ARTS",3.198,"G"
570,650,1220,"BUSINESS",3.4027,"G"
630,770,1400,"LIBERAL ARTS",3.9393,"G"
710,660,1370,"COMMUNICATIONS",3.4754,"G"
690,790,1480,"ENGINEERING",3.8218,"G"
520,670,1190,"NATURAL SCIENCE",3.5137,"G"
570,730,1300,"NATURAL SCIENCE",3.7678,"G"
590,630,1220,"NATURAL SCIENCE",3.7142,"G"
500,670,1170,"COMMUNICATIONS",3.1122,"G"
710,710,1420,"BUSINESS",3.8018,"G"
610,690,1300,"LIBERAL ARTS",3.3275,"G"
540,690,1230,"NATURAL SCIENCE",2.472,"G"
540,490,1030,"COMMUNICATIONS",3.866,"G"
580,680,1260,"NATURAL SCIENCE",3.8015,"G"
340,720,1060,"NATURAL SCIENCE",2.9615,"G"
660,680,1340,"ENGINEERING",3.8283,"G"
670,590,1260,"LIBERAL ARTS",3.4946,"G"
660,690,1350,"NATURAL SCIENCE",3.9532,"G"
510,650,1160,"BUSINESS",3.1284,"G"
650,590,1240,"NATURAL SCIENCE",3.5728,"G"
500,590,1090,"LIBERAL ARTS",2.4712,"G"
480,570,1050,"LIBERAL ARTS",2.8016,"G"
660,700,1360,"ENGINEERING",4,"G"
630,640,1270,"LIBERAL ARTS",3,"G"
560,540,1100,"LIBERAL ARTS",2.5454,"G"
450,490,940,"LIBERAL ARTS",3.0952,"G"
800,700,1500,"ENGINEERING",2.6048,"G"
690,730,1420,"ENGINEERING",3.4957,"G"
600,760,1360,"BUSINESS",3.5,"G"
520,500,1020,"BUSINESS",3.314,"G"
610,690,1300,"NATURAL SCIENCE",3.2105,"G"
560,560,1120,"BUSINESS",3.2452,"G"
660,770,1430,"LIBERAL ARTS",3.9642,"G"
630,630,1260,"BUSINESS",2.5483,"G"
400,600,1000,"LIBERAL ARTS",2.2644,"G"
530,540,1070,"LIBERAL ARTS",3.6915,"G"
460,640,1100,"ENGINEERING",3.015,"G"
540,490,1030,"NATURAL SCIENCE",3.1666,"G"
400,800,1200,"ENGINEERING",3.6528,"G"
610,700,1310,"BUSINESS",3.8306,"G"
680,600,1280,"LIBERAL ARTS",3.2601,"G"
540,710,1250,"ENGINEERING",3.4087,"G"
770,790,1560,"NATURAL SCIENCE",4,"G"
660,740,1400,"NATURAL SCIENCE",3.9503,"G"
680,760,1440,"ENGINEERING",3.1256,"G"
500,690,1190,"NATURAL SCIENCE",3.7973,"G"
670,740,1410,"NATURAL SCIENCE",2.5779,"G"
